"","report_date","tBalance","yBalance","total_purchase_amt","direct_purchase_amt","purchase_bal_amt","purchase_bank_amt","total_redeem_amt","consume_amt","transfer_amt","tftobal_amt","tftocard_amt","share_amt","category1","category2","category3","category4"
"1",2013-07-01,280567690,259273317,22533121,22502672,14140316,8362356,1238748,1199570,39178,39178,0,30449,0,6500,0,1193070
"2",2013-07-02,306977031,280567690,29624840,29591090,16106502,13484588,3215499,266571,2948928,2948928,0,33750,0,134100,0,132471
"3",2013-07-03,325117053,306977031,22525940,22485387,15129464,7355923,4385918,771851,3614067,3614067,0,40553,123220,60000,0,588631
"4",2013-07-04,344383113,325117053,32111643,32068710,24635710,7433000,12845583,901346,11944237,11944237,0,42933,12909,22350,0,866087
"5",2013-07-05,357961334,344383113,16129924,16086829,7333000,8753829,2551703,506884,2044819,2044819,0,43095,92110,182850,0,231924
"6",2013-07-06,371851858,357961334,16179865,16133269,11553423,4579846,2289341,610312,1679029,1679029,0,46596,305000,119500,0,185812
"7",2013-07-07,383004960,371851858,15516443,15469391,12158881,3310510,4363341,355660,4007681,4007681,0,47052,203940,0,0,151720
"8",2013-07-08,465847432,383004960,98730828,98684730,92432577,6252153,15888356,1151535,14736821,14736821,0,46098,587874,105029,0,458632
"9",2013-07-09,473096232,465847432,18623071,18576844,14396674,4180170,11374271,714141,10660130,10660130,0,46227,23404,352100,0,338637
"10",2013-07-10,496987242,473096232,42210154,42152074,33207722,8944352,18319144,1631597,16687547,16687547,0,58080,7800,396390,0,1227407
"11",2013-07-11,524671275,496987242,29843023,29785800,22898235,6887565,2158990,591657,1567333,1567333,0,57223,0,144400,0,447257
"12",2013-07-12,543044447,524671275,23202473,23140797,21496062,1644735,4829301,606899,4222402,4222402,0,61676,15584,3900,0,587415
"13",2013-07-13,560044022,543044447,19218553,19153972,10859896,8294076,2218978,1213796,1005182,1005182,0,64581,749538,60110,0,404148
"14",2013-07-14,657877371,560044022,101209093,101142953,97145183,3997770,3375744,1544520,1831224,1831224,0,66140,516053,158801,0,869666
"15",2013-07-15,738773170,657877371,106271409,106207543,99138126,7069417,25375610,690012,24685598,24685598,0,63866,218250,37704,0,434058
"16",2013-07-16,732931563,738773170,26323198,26249079,19190204,7058875,32164805,1802373,30362432,30362432,0,74119,1098822,6100,0,697451
"17",2013-07-17,735134015,732931563,28834269,28750910,19330209,9420701,26631817,2844758,23787059,23787059,0,83359,2e+06,521300,0,323458
"18",2013-07-18,754601099,735134015,27609385,27524976,18103728,9421248,8142301,1305095,6837206,6837206,0,84409,147961,264300,0,892834
"19",2013-07-19,877488802,754601099,126301368,126214101,116438521,9775580,3413665,1563103,1850562,1850562,0,87267,1125498,40670,0,396935
"20",2013-07-20,893593705,877488802,20662791,20573182,9953584,10619598,4557888,1565305,2992583,2992583,0,89609,830134,217800,0,517371
"21",2013-07-21,967901329,893593705,81375803,81285835,76051418,5234417,7068179,1493558,5574621,5574621,0,89968,310673,78000,0,1104885
"22",2013-07-22,996672095,967901329,37844074,37756694,33540370,4216324,9073308,1000374,8072934,8072934,0,87380,25689,226026,0,748659
"23",2013-07-23,1013111836,996672095,25115410,25013190,17934667,7078523,8675669,1653115,7022554,7022554,0,102220,969010,325646,0,358459
"24",2013-07-24,1033168999,1013111836,29405789,29289408,22591024,6698384,9348626,1048058,8300568,8300568,0,116381,602346,90700,0,355012
"25",2013-07-25,1094439801,1033168999,123922858,123806262,115261805,8544457,62652056,3144501,59507555,59507555,0,116596,419606,42600,0,2682295
"26",2013-07-26,1108553705,1094439801,25835746,25721550,19005025,6716525,11721842,1303120,10418722,10418722,0,114196,705555,29203,0,568362
"27",2013-07-27,1133851837,1108553705,31021548,30894865,16813821,14081044,5723416,1894447,3828969,3828969,0,126683,890000,200540,0,803907
"28",2013-07-28,1127224771,1133851837,26260152,26133373,17681455,8451918,32887218,3230419,29656799,29656799,0,126779,2118617,97500,0,1014302
"29",2013-07-29,1171979427,1127224771,59130418,59007801,47890006,11117795,14375762,565772,13809990,13809990,0,122617,72310,104388,0,389074
"30",2013-07-30,1190962021,1171979427,35410500,35281515,26947112,8334403,16427906,1018281,15409625,15409625,0,128985,30765,299656,0,687860
"31",2013-07-31,1300752719,1190962021,122942064,122802640,101493461,21309179,13151366,1055178,12096188,12096188,0,139424,0,43100,0,1012078
"32",2013-08-01,1356499509,1300752719,61905830,61764339,43674529,18089810,6159040,1500737,4658303,4658303,0,141491,510000,50724,0,940013
"33",2013-08-02,1409193015,1356499509,73104389,72946287,60196614,12749673,20410883,2073885,18336998,18336998,0,158102,1086354,213047,0,774484
"34",2013-08-03,1415621430,1409193015,31370682,31208415,27596463,3611952,24942267,858743,24083524,24083524,0,162267,225390,233111,0,400242
"35",2013-08-04,1444224511,1415621430,45251520,45090890,36177767,8913123,16648439,2095237,14553202,14553202,0,160630,2900,302319,0,1790018
"36",2013-08-05,1372645732,1444224511,51533056,51376270,31267567,20108703,123111835,1530976,121580859,121580859,0,156786,388038,535451,0,607487
"37",2013-08-06,1376690218,1372645732,27348705,27197221,18783430,8413791,23304219,1965428,21338791,21338791,0,151484,608200,133000,0,1224228
"38",2013-08-07,1387968567,1376690218,24953363,24790194,16637468,8152726,13675014,2053840,11621174,11621174,0,163169,1309925,86184,0,657731
"39",2013-08-08,1422110062,1387968567,44702970,44537579,30662735,13874844,10561475,2993652,7567823,7567823,0,165391,2477618,33987,0,482047
"40",2013-08-09,1452761754,1422110062,46197838,46029750,29283211,16746539,15546146,1045192,14500954,14500954,0,168088,0,158600,0,886592
"41",2013-08-10,1455223012,1452761754,44403831,44233582,39241996,4991586,41942573,3922065,38020508,38020508,0,170249,1777508,898785,0,1245772
"42",2013-08-11,1492620945,1455223012,42840984,42674222,38048951,4625271,5443051,1729114,3713937,3713937,0,166762,868000,163950,0,697164
"43",2013-08-12,1482989311,1492620945,33901418,33738035,20732902,13005133,43533052,1747140,41785912,41785912,0,163383,410000,53700,0,1283440
"44",2013-08-13,1499519965,1482989311,45856548,45689861,28678905,17010956,29325894,1872616,27453278,27453278,0,166687,91488,377900,0,1403228
"45",2013-08-14,1514865062,1499519965,39066415,38888544,20020584,18867960,23721318,1737373,21983945,21983945,0,177871,295293,545092,0,896988
"46",2013-08-15,1522122182,1514865062,29238678,29059058,16533407,12525651,21981558,1909768,20071790,20071790,0,179620,410900,245153,0,1253715
"47",2013-08-16,1518443646,1522122182,54635823,54454147,46805362,7648785,58314359,978171,57336188,57336188,0,181676,79675,224000,0,674496
"48",2013-08-17,1482674715,1518443646,15688245,15507070,5312811,10194259,51457176,2920376,48536800,48490854,45946,181175,1609250,268056,0,1043070
"49",2013-08-18,1492158494,1482674715,45069353,44893407,26123512,18769895,35585574,1069899,34515675,33564849,950826,175946,6246,339700,0,723953
"50",2013-08-19,1513068257,1492158494,48319110,48148456,28063111,20085345,27409347,1673824,25735523,24051175,1684348,170654,666792,63120,0,943912
"51",2013-08-20,1537369786,1513068257,51304276,51130804,21077598,30053206,27002747,2023168,24979579,24743538,236041,173472,1103942,240300,0,678926
"52",2013-08-21,1564762311,1537369786,45762636,45580125,19939480,25640645,18370111,2082502,16287609,15195799,1091810,182511,95611,355836,0,1631055
"53",2013-08-22,1572687349,1564762311,26545809,26361116,16001677,10359439,18620771,3503993,15116778,2428247,12688531,184693,2253959,340765,0,909269
"54",2013-08-23,1590532777,1572687349,33855284,33666183,16400288,17265895,16009856,1538685,14471171,12556865,1914306,189101,224730,247290,0,1066665
"55",2013-08-24,1630680253,1590532777,54574111,54384504,40988192,13396312,14426635,2367658,12058977,4961168,7097809,189607,551845,962623,0,853190
"56",2013-08-25,1635840324,1630680253,17586501,17397352,10997586,6399766,12426430,3509455,8916975,8762279,154696,189149,2671602,194620,0,643233
"57",2013-08-26,1671090382,1635840324,52044963,51861372,41628801,10232571,16794905,2065328,14729577,8991833,5737744,183591,259720,264590,0,1541018
"58",2013-08-27,1696789616,1671090382,49273164,49082554,39525564,9556990,23573930,3117900,20456030,8392017,12064013,190610,1922865,3e+05,0,895035
"59",2013-08-28,1685353974,1696789616,57249467,57049791,41561760,15488031,68685109,3830415,64854694,6781876,58072818,199676,2197590,263067,0,1369758
"60",2013-08-29,1686366204,1685353974,31008331,30793612,25236052,5557560,29996101,4602608,25393493,6176329,19217164,214719,3038640,197708,0,1366260
"61",2013-08-30,1697906931,1686366204,29172174,28938989,15741366,13197623,17631447,3944857,13686590,13159235,527355,233185,1952700,367096,0,1625061
"62",2013-08-31,1712733150,1697906931,27720016,27516648,20377914,7138734,12893797,2831760,10062037,7020217,3041820,203368,1792801,71660,0,967299
"63",2013-09-01,1754854153,1712733150,60276302,60073843,46978515,13095328,18155299,3670712,14484587,3090858,11393729,202459,1658696,665245,0,1346771
"64",2013-09-02,1769585532,1754854153,42168974,41929133,29423681,12505452,27437595,9166900,18270695,8704830,9565865,239841,7816105,375896,0,974899
"65",2013-09-03,1807044403,1769585532,58345539,58139248,31959074,26180174,20886668,2700732,18185936,7347956,10837980,206291,338664,921889,0,1440179
"66",2013-09-04,1838657333,1807044403,55301172,55084883,27406784,27678099,23688242,2002058,21686184,6592151,15094033,216289,909707,403850,0,688501
"67",2013-09-05,1863220908,1838657333,42500904,42280410,27775696,14504714,17937329,3328021,14609308,10071435,4537873,220494,1718998,551746,0,1057277
"68",2013-09-06,1879126074,1863220908,38650095,38375933,32755104,5620829,22744929,5531989,17212940,11140373,6072567,274162,3745199,417838,0,1368952
"69",2013-09-07,1911097439,1879126074,49801798,49573462,43380904,6192558,17830433,3152654,14677779,5505208,9172571,228336,1937784,368693,0,846177
"70",2013-09-08,1916514207,1911097439,24810658,24583925,16613375,7970550,19393890,3245533,16148357,4564656,11583701,226733,1663590,392680,0,1189263
"71",2013-09-09,1949549855,1916514207,55565482,55299764,33071148,22228616,22529834,4127573,18402261,7246619,11155642,265718,647868,399192,0,3080513
"72",2013-09-10,1968974098,1949549855,81305151,81041156,42728313,38312843,61880908,15458300,46422608,2324160,44098448,263995,11374109,964003,0,3120188
"73",2013-09-11,2016405468,1968974098,93077458,92841207,69183066,23658141,45646088,5719981,39926107,4514314,35411793,236251,3857800,537900,0,1324281
"74",2013-09-12,2049644326,2016405468,50035862,49793384,26106594,23686790,16797004,5658689,11138315,5575154,5563161,242478,3411298,648200,0,1599191
"75",2013-09-13,2087061315,2049644326,48041116,47765272,35159106,12606166,10624127,1808600,8815527,4513217,4302310,275844,309848,333575,0,1165177
"76",2013-09-14,2099176827,2087061315,34379286,34122646,21281351,12841295,22263774,3079714,19184060,4538698,14645362,256640,1655167,424000,0,1000547
"77",2013-09-15,2120747966,2099176827,38956366,38700933,17217667,21483266,17385227,5634249,11750978,853020,10897958,255433,4341713,89800,0,1202736
"78",2013-09-16,2210870928,2120747966,104399397,104112508,62750754,41361754,14276435,3109453,11166982,6044315,5122667,286889,968347,644363,0,1496743
"79",2013-09-17,2265058108,2210870928,75209349,74952042,49253273,25698769,21022169,3303142,17719027,7357477,10361550,257307,992310,795872,0,1514960
"80",2013-09-18,2289249638,2265058108,41969227,41676513,19003992,22672521,17777697,3089720,14687977,3804555,10883422,292714,2093607,207320,0,788793
"81",2013-09-19,2319015925,2289249638,40861546,40578994,29908293,10670701,11095259,1848349,9246910,3900208,5346702,282552,225500,67650,0,1555199
"82",2013-09-20,2336907122,2319015925,33601331,33314898,18970383,14344515,15710134,5894084,9816050,3799387,6016663,286433,3414531,237000,0,2242553
"83",2013-09-21,2375329810,2336907122,61641978,61352772,55025567,6327205,23219290,7155368,16063922,4365888,11698034,289206,4913280,385090,0,1856998
"84",2013-09-22,2358712937,2375329810,59188234,58901313,39525891,19375422,75805107,5797992,70007115,37904910,32102205,286921,3941305,746412,0,1110275
"85",2013-09-23,2369486968,2358712937,37338427,37063111,24132612,12930499,26564396,3438265,23126131,7525512,15600619,275316,1111347,669100,0,1657818
"86",2013-09-24,2398773150,2369486968,56008378,55709534,38870368,16839166,26722196,5033655,21688541,4030406,17658135,298844,3411041,405626,0,1216988
"87",2013-09-25,2451415882,2398773150,107206248,106880957,72730654,34150303,54563516,8592606,45970910,9898931,36071979,325291,6637557,141328,0,1813721
"88",2013-09-26,2468765438,2451415882,49684160,49345581,26045957,23299624,32334604,10118799,22215805,5084150,17131655,338579,7591912,1420150,0,1106737
"89",2013-09-27,2498419633,2468765438,51076556,50743216,31193577,19549639,21422361,5246300,16176061,4460362,11715699,333340,3077324,547172,0,1621804
"90",2013-09-28,2507517815,2498419633,46758852,46437755,18123455,28314300,37660670,4886816,32773854,5401747,27372107,321097,1496987,279624,0,3110205
"91",2013-09-29,2506095067,2507517815,76038490,75720045,63674192,12045853,77461238,6882049,70579189,18523244,52055945,318445,4230000,1000783,0,1651266
"92",2013-09-30,2521145674,2506095067,49151321,48840287,36660233,12180054,34100714,6586876,27513838,15130243,12383595,311034,3523961,567535,0,2495380
"93",2013-10-01,2535135032,2521145674,22858568,22540090,6968440,15571650,8869210,2029701,6839509,3042784,3796725,318478,586936,612920,0,829845
"94",2013-10-02,2540441838,2535135032,15700008,15369419,7568936,7800483,10393202,5441231,4951971,3027707,1924264,330589,3619000,1029494,0,792737
"95",2013-10-03,2532993043,2540441838,7251212,6919037,2848099,4070938,14700007,8037550,6662457,1374736,5287721,332175,5210326,175000,0,2652224
"96",2013-10-04,2543815092,2532993043,22868589,22536444,16994428,5542016,12046540,3663642,8382898,4630229,3752669,332145,2489466,64043,0,1110133
"97",2013-10-05,2552040358,2543815092,21245166,20913463,12398601,8514862,13019900,2137206,10882694,4162463,6720231,331703,594920,491949,0,1050337
"98",2013-10-06,2577624656,2552040358,40318288,39989569,27399814,12589755,14733990,8375247,6358743,4041920,2316823,328719,4002343,2181309,0,2191595
"99",2013-10-07,2551748907,2577624656,56730939,56403577,38085109,18318468,82606688,6253120,76353568,14605167,61748401,327362,2328857,1374106,0,2550157
"100",2013-10-08,2606038224,2551748907,115047417,114684319,85494256,29190063,60758100,6787407,53970693,11851857,42118836,363098,3785296,391390,0,2610721
"101",2013-10-09,2646766870,2606038224,67339813,67017704,40227052,26790652,26611167,5516809,21094358,4717662,16376696,322109,3118543,1553413,0,844853
"102",2013-10-10,2704276450,2646766870,93642539,93304906,54136413,39168493,36132959,5512242,30620717,2129323,28491394,337633,3810614,441639,0,1259989
"103",2013-10-11,2741475909,2704276450,68845671,68502962,30953515,37549447,31646212,3968613,27677599,5859621,21817978,342709,1499112,334185,0,2135316
"104",2013-10-12,2800064502,2741475909,95312628,94963221,64858020,30105201,36724035,3969077,32754958,7862846,24892112,349407,1452575,423916,0,2092586
"105",2013-10-13,2793557650,2800064502,40381173,40032633,23316317,16716316,46888025,3502059,43385966,7734419,35651547,348540,574176,1620200,0,1307683
"106",2013-10-14,2910472479,2793557650,158158044,157821450,124249101,33572349,41243215,4014473,37228742,4244494,32984248,336594,1856274,547200,0,1610999
"107",2013-10-15,2960961762,2910472479,108776071,108420341,70850621,37569720,58286788,5327927,52958861,17002218,35956643,355730,1511466,1160233,0,2656228
"108",2013-10-16,3077256887,2960961762,156977224,156603156,107487455,49115701,40682099,4961558,35720541,14331238,21389303,374068,2660646,255489,0,2045423
"109",2013-10-17,3105093789,3077256887,73354575,72976649,29558558,43418091,45517673,6044008,39473665,14564030,24909635,377926,4033900,988700,0,1021408
"110",2013-10-18,3156023345,3105093789,80573607,80182522,40782542,39399980,29644051,5235727,24408324,10151775,14256549,391085,894709,729582,0,3611436
"111",2013-10-19,3191048643,3156023345,47140830,46745709,21276944,25468765,12115532,3913885,8201647,6650807,1550840,395121,1480037,984504,0,1449344
"112",2013-10-20,3241954238,3191048643,78146352,77751112,50725520,27025592,27240757,4058493,23182264,8673567,14508697,395240,1462766,376750,0,2218977
"113",2013-10-21,3247632482,3241954238,92303765,91893353,40652555,51240798,86625521,14499661,72125860,29245767,42880093,410412,8937573,184976,0,5377112
"114",2013-10-22,3298143009,3247632482,79936840,79546827,42980855,36565972,29426313,6568278,22858035,5288609,17569426,390013,3305213,293199,0,2969866
"115",2013-10-23,3353317534,3298143009,91267273,90858249,49900947,40957302,36092748,10091591,26001157,4516810,21484347,409024,5686919,2362685,0,2041987
"116",2013-10-24,3361853569,3353317534,78253878,77836438,36198944,41637494,69717843,12002970,57714873,13328998,44385875,417440,6571640,1671006,0,3760324
"117",2013-10-25,3372042654,3361853569,72866681,72447322,40877617,31569705,62677596,7272391,55405205,11307679,44097526,419359,4352258,525543,0,2394590
"118",2013-10-26,3433690861,3372042654,89152724,88732584,53553142,35179442,27504517,3884163,23620354,3938287,19682067,420140,1973409,490223,0,1420531
"119",2013-10-27,3466404627,3433690861,58360160,57941819,31723985,26217834,25646394,8912469,16733925,2991698,13742227,418341,7636553,169700,0,1106216
"120",2013-10-28,3574644359,3466404627,175987478,175579262,139068876,36510386,67747746,8397637,59350109,6328760,53021349,408216,3748431,625032,0,4024174
"121",2013-10-29,3669848507,3574644359,147891369,147466261,92994403,54471858,52687221,5568015,47119206,10609627,36509579,425108,2229810,495593,0,2842612
"122",2013-10-30,3729908333,3669848507,123495252,123041276,73844565,49196711,63435426,9944894,53490532,21587379,31903153,453976,2957122,2016389,0,4971383
"123",2013-10-31,3741721725,3729908333,105655220,105186820,63832734,41354086,93841828,9008680,84833148,11402473,73430675,468400,3946439,1939459,0,3122782
"124",2013-11-01,3785096256,3741721725,90052647,89583024,49135445,40447579,46678116,6022119,40655997,3631756,37024241,469623,1673893,782271,0,3565955
"125",2013-11-02,3823914842,3785096256,60697754,60221119,33492424,26728695,21879168,3695380,18183788,10720255,7463533,476635,1193476,1348146,0,1153758
"126",2013-11-03,3899870984,3823914842,109705314,109229185,54544387,54684798,33749172,14756793,18992379,4449195,14543184,476129,11756073,236780,0,2763940
"127",2013-11-04,3926257646,3899870984,134705147,134230951,50095649,84135302,108318485,11163837,97154648,59527504,37627144,474196,6944314,1294048,0,2925475
"128",2013-11-05,3967784566,3926257646,170112074,169633176,76245313,93387863,128585154,15562031,113023123,33249058,79774065,478898,10303023,1953631,0,3305377
"129",2013-11-06,4013169530,3967784566,177181307,176687416,61444329,115243087,131796343,11154579,120641764,28279936,92361828,493891,6089946,1205042,0,3859591
"130",2013-11-07,4082936823,4013169530,219191421,218691748,110061517,108630231,149424128,13906471,135517657,18376077,117141580,499673,8395443,1525399,0,3985629
"131",2013-11-08,4232992711,4082936823,249304249,248801248,114283436,134517812,99248361,18642499,80605862,21102525,59503337,503001,13610867,1344855,0,3686777
"132",2013-11-09,4297397563,4232992711,123652022,123135576,41727804,81407772,59247170,5585151,53662019,13228399,40433620,516446,1403003,905498,0,3276650
"133",2013-11-10,4332550581,4297397563,158993537,158468355,45623758,112844597,123840519,15041292,108799227,27528397,81270830,525182,6701195,1599460,0,6740637
"134",2013-11-11,4229902364,4332550581,143416540,142812136,69579940,73232196,246064757,129341796,116722961,35469408,81253553,604404,8278504,3723255,27400000,89940037
"135",2013-11-12,4328995512,4229902364,173549641,172963461,99475201,73488260,74456493,15010529,59445964,19085434,40360530,586180,5740069,3058015,9e+05,5312445
"136",2013-11-13,4433069721,4328995512,158376990,157791004,67099024,90691980,54302781,11101063,43201718,11156044,32045674,585986,4682696,2996881,0,3421486
"137",2013-11-14,4539080718,4433069721,148622821,148054203,80609317,67444886,42611824,12824954,29786870,15245742,14541128,568618,4852316,2231870,0,5740768
"138",2013-11-15,4610812964,4539080718,116112820,115465600,51629240,63836360,44380574,11096779,33283795,10649032,22634763,647220,7440938,604830,0,3051011
"139",2013-11-16,4657850161,4610812964,85621804,85033630,38767945,46265685,38584607,8489457,30095150,9073155,21021995,588174,5943784,460670,0,2085003
"140",2013-11-17,4721287293,4657850161,98492364,97905348,37972564,59932784,35055232,10042765,25012467,5249938,19762529,587016,4377198,698092,0,4967475
"141",2013-11-18,4800692315,4721287293,145222355,144628244,61595035,83033209,65817333,15681247,50136086,9602551,40533535,594111,5779747,5648956,1e+05,4152544
"142",2013-11-19,4906622053,4800692315,165943591,165337268,91178353,74158915,60013853,10356816,49657037,22084023,27573014,606323,4204643,1734409,0,4417764
"143",2013-11-20,4972518980,4906622053,149019647,148386907,52321781,96065126,83122720,18303990,64818730,12380419,52438311,632740,12157564,2479453,4e+05,3266973
"144",2013-11-21,5133388034,4972518980,236672974,236024199,145729182,90295017,75803920,14102751,61701169,9296988,52404181,648775,5174766,4820591,0,4107394
"145",2013-11-22,5205905093,5133388034,139140591,138480171,60808667,77671504,66623532,10449514,56174018,11972209,44201809,660420,5604705,1333421,0,3511388
"146",2013-11-23,5202690965,5205905093,85234876,84552434,34798863,49753571,88449004,18499480,69949524,26735542,43213982,682442,13961868,1209921,0,3327691
"147",2013-11-24,5239857884,5202690965,97522283,96847911,56288754,40559157,60355364,12714653,47640711,18289525,29351186,674372,9242766,1611117,0,1860770
"148",2013-11-25,5336650893,5239857884,188023955,187345562,94887039,92458523,91230946,17080458,74150488,23156837,50993651,678393,10149877,750065,0,6180516
"149",2013-11-26,5438128871,5336650893,181397027,180702465,90999756,89702709,79919049,28690198,51228851,25171049,26057802,694562,19359004,4790045,1e+06,3541149
"150",2013-11-27,5411755297,5438128871,152083973,151360654,72606318,78754336,178457547,15702980,162754567,28767887,133986680,723319,5969829,2757339,0,6975812
"151",2013-11-28,5457202244,5411755297,152510165,151779605,60514019,91265586,107063218,28629013,78434205,10745013,67689192,730560,14756772,9218851,0,4653390
"152",2013-11-29,5505795946,5457202244,144836611,144100062,57513910,86586152,96242909,11700430,84542479,15134800,69407679,736549,6907086,1730550,0,3062794
"153",2013-11-30,5524022654,5505795946,94687796,93944263,37918957,56025306,76461088,9381586,67079502,28456254,38623248,743533,5107296,1040114,0,3234176
"154",2013-12-01,5607811650,5524022654,179080325,178343482,99541384,78802098,95291329,17494218,77797111,18142190,59654921,736843,11474576,2474149,0,3545493
"155",2013-12-02,5708533984,5607811650,207768089,207039619,103750788,103288831,107045755,20699489,86346266,37322794,49023472,728470,14636980,1829994,0,4232515
"156",2013-12-03,5779782867,5708533984,176533224,175790780,61846318,113944462,105284341,14500818,90783523,48056319,42727204,742444,7754266,1625273,0,5121279
"157",2013-12-04,5941776719,5779782867,253181565,252397853,150764211,101633642,91187713,19043951,72143762,25683361,46460401,783712,10881415,2829857,0,5332679
"158",2013-12-05,6018840122,5941776719,152989262,152191851,46189834,106002017,75925859,10414186,65511673,12278704,53232969,797411,5250305,1289729,0,3874152
"159",2013-12-06,6124711277,6018840122,198597129,197785236,105170216,92615020,92725974,21967172,70758802,22031997,48726805,811893,14216993,4508095,0,3242084
"160",2013-12-07,6187291998,6124711277,116093484,115274858,49420711,65854147,53512763,9497715,44015048,8995609,35019439,818626,4919827,716280,0,3861608
"161",2013-12-08,6261175751,6187291998,127532403,126718009,67930320,58787689,53648650,19142847,34505803,11357960,23147843,814394,14849165,474321,0,3819361
"162",2013-12-09,6323433067,6261175751,214664521,213825603,96718199,117107404,152407205,14723824,137683381,10779163,126904218,838918,6971986,3464600,0,4287238
"163",2013-12-10,6526476695,6323433067,281121012,280275100,152476206,127798894,78077384,15686013,62391371,22977996,39413375,845912,7848681,3068792,0,4768540
"164",2013-12-11,6716375028,6526476695,316266609,315379409,187366154,128013255,126368276,18645788,107722488,52750372,54972116,887200,11865118,2801445,0,3979225
"165",2013-12-12,6771103277,6716375028,172183635,171242986,67486205,103756781,117455386,35622088,81833298,19852814,61980484,940649,11143237,3064173,0,21414678
"166",2013-12-13,6834382209,6771103277,146722615,145762999,60416854,85346145,83443683,17538248,65905435,12692904,53212531,959616,7001720,7003931,0,3532597
"167",2013-12-14,6895971004,6834382209,134839018,133869389,73763461,60105928,73250223,17627499,55622724,12094731,43527993,969629,11341925,2361709,0,3923865
"168",2013-12-15,6955692802,6895971004,119396143,118432625,44148819,74283806,59674345,11653261,48021084,11340861,36680223,963518,6452380,1256350,0,3944531
"169",2013-12-16,7057656376,6955692802,188230089,187251045,50934507,136316538,86266515,17649818,68616697,17995840,50620857,979044,4340562,8894552,0,4414704
"170",2013-12-17,7161363781,7057656376,212780998,211807641,115568358,96239283,109073593,24237022,84836571,11012914,73823657,973357,16434667,1899375,0,5902980
"171",2013-12-18,7260788901,7161363781,190985922,189975254,58972461,131002793,91560802,12830997,78729805,19419751,59310054,1010668,7342984,1875224,0,3612789
"172",2013-12-19,7292444331,7260788901,144026114,142954219,56976848,85977371,112370684,13368859,99001825,22604848,76396977,1071895,8008118,1372657,200,3987884
"173",2013-12-20,7275432992,7292444331,131176893,130095972,52388143,77707829,148188232,18543936,129644296,21791051,107853245,1080921,8965360,4926577,100,4651899
"174",2013-12-21,7307341612,7275432992,91445173,90365725,27579880,62785845,59536553,13844669,45691884,9207541,36484343,1079448,7712379,2024225,5e+05,3608065
"175",2013-12-22,7391023064,7307341612,140558599,139482501,84436722,55045779,56877147,13318782,43558365,12235066,31323299,1076098,7195653,1151127,1e+05,4872002
"176",2013-12-23,7401466684,7391023064,190330016,189177974,66247253,122930721,179886396,27649415,152236981,30948575,121288406,1152042,15728783,5255885,10100,6654647
"177",2013-12-24,7450814369,7401466684,182690432,181550629,81487409,100063220,133342747,18012909,115329838,39349876,75979962,1139803,9870775,2112186,2e+05,5829948
"178",2013-12-25,7391845479,7450814369,153343940,152106264,61454161,90652103,212312830,22742345,189570485,66728903,122841582,1237676,14027484,3531355,250000,4933506
"179",2013-12-26,7433016331,7391845479,187935531,186655291,69444400,117210891,146764679,22498033,124266646,31034650,93231996,1280240,9231237,6920332,2e+06,4346464
"180",2013-12-27,7354497650,7433016331,173898861,172591563,61880635,110710928,252417542,25698095,226719447,38642066,188077381,1307298,14258577,6469703,10100,4959715
"181",2013-12-28,7452501196,7354497650,199852196,198567562,60195068,138372494,101848650,13176851,88671799,29315769,59356030,1284634,8344434,1647218,0,3185199
"182",2013-12-29,7551610773,7452501196,173772752,172499257,51842398,120656859,74663175,9465515,65197660,17584494,47613166,1273495,4906246,1176723,0,3382546
"183",2013-12-30,7734116093,7551610773,286491118,285209870,125657110,159552760,103985798,13875129,90110669,38876191,51234478,1281248,6075572,3191611,0,4607946
"184",2013-12-31,7947836365,7734116093,326974771,325688543,177058473,148630070,113254499,20684682,92569817,19959114,72610703,1286228,6705162,8093151,0,5886369
"185",2014-01-01,8206625677,7947836365,335862570,334501233,165317029,169184204,77073258,24631501,52441757,8451493,43990264,1361337,10401098,7665623,0,6564780
"186",2014-01-02,8383263636,8206625677,301179400,299752599,103993444,195759155,124541441,22414243,102127198,22817045,79310153,1426801,12216266,2893761,0,7304216
"187",2014-01-03,8559238524,8383263636,291336871,289890616,107736915,182153701,115361983,21470139,93891844,16768518,77123326,1446255,11955593,2404659,10000,7099887
"188",2014-01-04,8643347794,8559238524,155828144,154355236,47510428,106844808,71718874,18183461,53535413,7742758,45792655,1472908,9221919,3665489,0,5296053
"189",2014-01-05,8857866434,8643347794,321343539,319875293,225428542,94446751,106824899,18138045,88686854,41414118,47272736,1468246,10990567,2546887,0,4600591
"190",2014-01-06,9090316943,8857866434,371683914,370222127,199359208,170862919,139233405,32832378,106401027,39085554,67315473,1461787,17056759,3730044,2e+06,10045575
"191",2014-01-07,9320015097,9090316943,339901798,338373341,113252891,225120450,110203644,29708950,80494694,21198786,59295908,1528457,15797541,3866577,0,10044832
"192",2014-01-08,9476243310,9320015097,271765172,270126294,123029087,147097207,115536959,20926081,94610878,17416975,77193903,1638878,8414383,3452818,3e+05,8758880
"193",2014-01-09,9700084288,9476243310,345036273,343411913,164143768,179268145,121195295,24833148,96362147,21712672,74649475,1624360,13735951,1628778,2e+05,9268419
"194",2014-01-10,9877218546,9700084288,296993855,295319545,98322725,196996820,119859597,39482547,80377050,23296683,57080367,1674310,24021540,8501350,4e+05,6559657
"195",2014-01-11,9938687375,9877218546,178289447,176615910,50878197,125737713,116820618,26920145,89900473,24818463,65082010,1673537,16910710,2883132,1e+06,6126303
"196",2014-01-12,10050774727,9938687375,192128885,190458340,41216893,149241447,80041533,17752631,62288902,11692549,50596353,1670545,5676492,5648426,0,6427713
"197",2014-01-13,10178528684,10050774727,292143045,290463215,47682065,242781150,164389088,27499710,136889378,40458604,96430774,1679830,10379562,10231524,0,6888624
"198",2014-01-14,10320753176,10178528684,337203610,335497080,94309152,241187928,194979118,20603205,174375913,33929454,140446459,1706530,6382950,6229616,1e+05,7890639
"199",2014-01-15,10439166908,10320753176,233318844,231587163,54758381,176828782,114905112,18703026,96202086,23614174,72587912,1731681,4607971,2896637,0,11198418
"200",2014-01-16,10792799158,10439166908,490563564,488804509,171061850,317742659,136931314,27690054,109241260,25235773,84005487,1759055,10320058,9338086,50000,7981910
"201",2014-01-17,10900581668,10792799158,262046075,260277661,77747209,182530452,154263565,20319615,133943950,41369884,92574066,1768414,8585453,1807390,0,9926772
"202",2014-01-18,10977632480,10900581668,184240864,182453586,60030251,122423335,107190052,19713867,87476185,14924270,72551915,1787278,7941423,2000145,0,9772299
"203",2014-01-19,11161309455,10977632480,301523785,299746334,79675608,220070726,117846810,14990039,102856771,18680964,84175807,1777451,5160128,2848223,0,6981688
"204",2014-01-20,11213364394,11161309455,312028349,310204310,91443411,218760899,259973410,36050869,223922541,28948047,194974494,1824039,17400840,9035403,1e+05,9514626
"205",2014-01-21,11373735820,11213364394,337095722,335295077,112036677,223258400,176724296,41489564,135234732,34403820,100830912,1800645,19200642,9949493,1200000,11139429
"206",2014-01-22,11652870112,11373735820,462593233,460727851,128461352,332266499,183458941,24765949,158692992,27978735,130714257,1865382,13109318,6722300,0,4934331
"207",2014-01-23,11614493946,11652870112,294368520,292409095,56767990,235641105,332744686,36272301,296472385,37210268,259262117,1959425,22980311,8220569,0,5071421
"208",2014-01-24,11876353593,11614493946,450511317,448547421,168853696,279693725,188651670,36422877,152228793,35129990,117098803,1963896,16602957,12598651,0,7221269
"209",2014-01-25,12094534831,11876353593,349192126,347267635,78285094,268982541,131010888,26555292,104455596,20575485,83880111,1924491,15724010,4875447,0,5955835
"210",2014-01-26,12327132156,12094534831,446945594,445012163,123666300,321345863,214348269,35124119,179224150,35679514,143544636,1933431,23980700,5010190,1500000,4633229
"211",2014-01-27,12782324052,12327132156,715461017,713542819,226124075,487418744,260269121,32800531,227468590,24542921,202925669,1918198,18359512,8165938,0,6275081
"212",2014-01-28,13396219381,12782324052,870587680,868580048,271528474,597051574,256692351,51412459,205279892,19522002,185757890,2007632,31410135,16264386,0,3737938
"213",2014-01-29,14305440525,13396219381,1183825013,1181722616,270116277,911606339,274603869,31028957,243574912,30456335,213118577,2102397,19705023,7229250,0,4094684
"214",2014-01-30,14448195313,14305440525,242566772,240420034,31110470,209309564,99811984,14785760,85026224,18378583,66647641,2146738,7286637,3767053,0,3732070
"215",2014-01-31,14509193948,14448195313,90124260,87833592,13340221,74493371,29125625,17944322,11181303,3840586,7340717,2290668,8404154,6973629,0,2566539
"216",2014-02-01,14558894055,14509193948,101183694,98866623,17606998,81259625,51483587,11593228,39890359,1511181,38379178,2317071,7545552,1039539,0,3008137
"217",2014-02-02,14610527678,14558894055,86649833,84334332,34128435,50205897,35016210,7914392,27101818,3086107,24015711,2315501,4818925,494933,0,2600534
"218",2014-02-03,14603759454,14610527678,85303404,82989462,15986250,67003212,92071628,19834695,72236933,7415792,64821141,2313942,14475287,3025388,0,2334020
"219",2014-02-04,14635007830,14603759454,92866528,90552030,20678169,69873861,61618152,14639956,46978196,4972042,42006154,2314498,9040827,2647031,0,2952098
"220",2014-02-05,14727027252,14635007830,162119647,159783859,50989439,108794420,70100225,15635273,54464952,11164720,43300232,2335788,8683859,3142564,0,3808850
"221",2014-02-06,14862902653,14727027252,225661839,223321716,77410561,145911155,89786438,25609125,64177313,11871176,52306137,2340123,18398051,3076325,10000,4124749
"222",2014-02-07,15128076639,14862902653,621409043,618918634,114651678,504266956,356235057,38734809,317500248,28906082,288594166,2490409,25217830,7006582,0,6510397
"223",2014-02-08,15308739535,15128076639,315242286,312784997,56761345,256023652,134579390,27946530,106632860,30120934,76511926,2457289,14174816,7134260,0,6637454
"224",2014-02-09,15502134689,15308739535,336607101,334156976,32170506,301986470,143211947,30581220,112630727,28421971,84208756,2450125,19025294,4925547,20000,6610379
"225",2014-02-10,15715822395,15502134689,632298767,629815651,122299917,507515734,418611061,41335508,377275553,38589814,338685739,2483116,18290890,16234010,0,6810608
"226",2014-02-11,16071053272,15715822395,670470102,667997291,126620567,541376724,315239225,46682708,268556517,28751388,239805129,2472811,17451965,13565466,5683000,9982277
"227",2014-02-12,16196938888,16071053272,551106906,548525971,125629629,422896342,425221290,41689934,383531356,19886095,363645261,2580935,13799868,10148698,3500000,14241368
"228",2014-02-13,16357072061,16196938888,461212821,458588546,68415824,390172722,301079648,43530030,257549618,44919631,212629987,2624275,18006285,14746589,2008100,8769056
"229",2014-02-14,16646031553,16357072061,522331058,519690088,197539466,322150622,233371566,57477083,175894483,17598467,158296016,2640970,14421070,6566717,26110000,10379296
"230",2014-02-15,16841005787,16646031553,305214647,302542045,62746121,239795924,110240413,29964229,80276184,23573091,56703093,2672602,16571149,5601204,0,7791876
"231",2014-02-16,17062823912,16841005787,361250311,358582299,101255138,257327161,139432186,25033326,114398860,25823818,88575042,2668012,8244467,7836524,1500000,7452335
"232",2014-02-17,17423610524,17062823912,675485671,672818788,167288895,505529893,314699059,30122564,284576495,37450182,247126313,2666883,11185615,6852734,1e+05,11984215
"233",2014-02-18,17600122427,17423610524,422741202,420055718,70493272,349562446,246229299,24385964,221843335,30890868,190952467,2685484,9121644,5601477,510000,9152843
"234",2014-02-19,17995445371,17600122427,642931201,640125179,171022695,469102484,247608257,27780742,219827515,28674437,191153078,2806022,8795072,4940821,0,14044849
"235",2014-02-20,18245895476,17995445371,527167832,524326256,102064032,422262224,276717727,37368218,239349509,44405867,194943642,2841576,14199196,6413718,3140000,13615304
"236",2014-02-21,18434069442,18245895476,394746918,391861133,70948708,320912425,206572952,30924388,175648564,33631822,142016742,2885785,13881521,3975201,3e+05,12767666
"237",2014-02-22,18539847457,18434069442,235659822,232728292,53377141,179351151,129881807,32933003,96948804,20353642,76595162,2931530,13861187,6353648,7e+05,12018168
"238",2014-02-23,18611220559,18539847457,308396249,305471716,85226555,220245161,237023147,38019495,199003652,22649314,176354338,2924533,22230757,8087161,10000,7691577
"239",2014-02-24,18879909342,18611220559,595170010,592253107,116950273,475302834,326481227,52662821,273818406,48223407,225594999,2916903,33342984,9251471,0,10068366
"240",2014-02-25,19244067093,18879909342,713994252,711119216,213652337,497466879,349836501,60481192,289355309,36793221,252562088,2875036,31292964,17594189,0,11594039
"241",2014-02-26,19253802420,19244067093,486006154,483042797,97680285,385362512,476270827,39066153,437204674,39264588,397940086,2963357,24251649,4628350,1125700,9060454
"242",2014-02-27,19130789681,19253802420,537812517,534847542,113116243,421731299,660825256,58469205,602356051,33683283,568672768,2964975,31027757,15536289,0,11905159
"243",2014-02-28,19268984260,19130789681,420504763,417561034,143491432,274069602,282310184,52180897,230129287,31187371,198941916,2943729,31507783,6294053,40000,14339061
"244",2014-03-01,19335911497,19268984260,215356482,212395497,51713389,160682108,148429245,39788871,108640374,28375434,80264940,2960985,17897210,6326164,0,15565497
"245",2014-03-02,19447903799,19335911497,275779265,272821873,96286760,176535113,163786963,46291035,117495928,20922963,96572965,2957392,15764823,18658688,604600,11262924
"246",2014-03-03,19611655097,19447903799,523895828,520971169,201575385,319395784,360144530,48158176,311986354,29388173,282598181,2924659,25805534,8944090,260000,13148552
"247",2014-03-04,19855038051,19611655097,521644375,518747507,214445435,304302072,278261421,45209878,233051543,37023763,196027780,2896868,14893914,15822846,4010000,10483118
"248",2014-03-05,20077325763,19855038051,497668868,494688047,144240130,350447917,275381156,52884087,222497069,53264362,169232707,2980821,26887048,11676534,8e+05,13520505
"249",2014-03-06,20207050612,20077325763,495755683,492764712,78255472,414509240,366030834,58080098,307950736,19628897,288321839,2990971,21632166,22874244,2600000,10973688
"250",2014-03-07,20425665101,20207050612,492623841,489624360,129854870,359769490,274009352,55190666,218818686,38764259,180054427,2999481,26635884,16319658,0,12235124
"251",2014-03-08,20483023507,20425665101,215355021,212335064,64428739,147906325,157996615,41632806,116363809,27730633,88633176,3019957,20488246,4711233,0,16433327
"252",2014-03-09,20609710369,20483023507,296559440,293539792,86667455,206872337,169872578,28057285,141815293,20714852,121100441,3019648,11986376,5700729,110000,10260180
"253",2014-03-10,20846533897,20609710369,533357693,530370838,113436193,416934645,296534165,50778011,245756154,42742601,203013553,2986855,26905982,14292176,40000,9539853
"254",2014-03-11,21068010731,20846533897,488913889,485925038,112577281,373347757,267437055,46554603,220882452,28455100,192427352,2988851,17209611,17673105,0,11671887
"255",2014-03-12,21086523158,21068010731,317050657,313963545,80981830,232981715,298538230,31663766,266874464,29446659,237427805,3087112,11747148,10806892,0,9109726
"256",2014-03-13,21269015235,21086523158,438410772,435321953,102703090,332618863,255918695,38613340,217305355,32243201,185062154,3088819,20051686,8832013,0,9729641
"257",2014-03-14,21318073807,21269015235,319556555,316457232,91143277,225313955,270497983,45707311,224790672,29759721,195030951,3099323,18802351,11937861,0,14967099
"258",2014-03-15,21277015403,21318073807,201137958,198025845,46618342,151407503,242196362,36236001,205960361,37443173,168517188,3112113,19898074,5832905,0,10505022
"259",2014-03-16,21308422662,21277015403,219592025,216500186,56265518,160234668,188184766,33297691,154887075,28366452,126520623,3091839,13574539,4007067,3e+06,12716085
"260",2014-03-17,21300316440,21308422662,411958428,408919917,116676049,292243868,420064650,38762249,381302401,45023763,336278638,3038511,13041517,10557432,2e+05,14963300
"261",2014-03-18,21261001464,21300316440,302616910,299576478,107687800,191888678,341931886,64325783,277606103,30539008,247067095,3040432,20416946,9294990,10000,34603847
"262",2014-03-19,21141458775,21261001464,295342178,292242134,69331791,222910343,414884867,31718886,383165981,41058263,342107718,3100044,10869792,8664985,4e+05,11784109
"263",2014-03-20,21140029481,21141458775,302584612,299504283,63195737,236308546,304013906,45429720,258584186,45595318,212988868,3080329,26345596,8278860,7e+05,10105264
"264",2014-03-21,21133452226,21140029481,274386390,271301471,84624128,186677343,280963645,42450695,238512950,40768480,197744470,3084919,22918066,10487170,250000,8795459
"265",2014-03-22,21078061203,21133452226,145506447,142453489,46294184,96159305,200897470,27038384,173859086,27746079,146113007,3052958,10224043,2432630,0,14381711
"266",2014-03-23,21084811989,21078061203,167604758,164575748,57500984,107074764,160853972,52687476,108166496,18983436,89183060,3029010,24761800,20163530,0,7762146
"267",2014-03-24,21096879506,21084811989,330726069,327726110,132297034,195429076,318658552,64726828,253931724,43343608,210588116,2999959,32606577,16349470,0,15770781
"268",2014-03-25,21071859880,21096879506,337425152,334448822,146210691,188238131,362444778,53477585,308967193,38705828,270261365,2976330,30039026,7865737,0,15572822
"269",2014-03-26,21240574516,21071859880,426653122,423677158,207737076,215940082,257938486,42902636,215035850,26145710,188890140,2975964,18204391,10202524,0,14495721
"270",2014-03-27,21180192090,21240574516,266160879,263191001,60426557,202764444,326543305,59590597,266952708,55755774,211196934,2969878,27211720,18097017,0,14281860
"271",2014-03-28,21031802786,21180192090,223771699,220789424,62439002,158350422,372161003,51846308,320314695,41563213,278751482,2982275,32982622,7147496,3e+05,11416190
"272",2014-03-29,21088557406,21031802786,194925803,191958577,77147539,114811038,138171183,29421365,108749818,33739820,75009998,2967226,14804632,4986087,0,9630646
"273",2014-03-30,20993229211,21088557406,161565264,158610631,53160507,105450124,256893459,25012252,231881207,34902113,196979094,2954633,7264875,7536729,0,10210648
"274",2014-03-31,20873473218,20993229211,377931423,374992035,101241422,273750613,497687416,47050841,450636575,80697714,369938861,2939388,21659483,9697526,30000,15663832
"275",2014-04-01,21017850420,20873473218,424784984,421871440,110112946,311758494,280407782,57046461,223361321,40251170,183110151,2913544,23516593,13225150,1120000,19184718
"276",2014-04-02,21201799735,21017850420,418550858,415588571,174236564,241352007,234601543,38868270,195733273,39039800,156693473,2962287,15527624,9205847,840000,13294799
"277",2014-04-03,21244485594,21201799735,301858010,298870511,76536813,222333698,259172151,43502360,215669791,34897849,180771942,2987499,20991859,10590921,0,11919580
"278",2014-04-04,21308841040,21244485594,235574221,232571834,73515221,159056613,171218775,38856167,132362608,29525605,102837003,3002387,14785040,9668025,3e+06,11403102
"279",2014-04-05,21349986488,21308841040,171320519,168303699,72227716,96075983,130175071,36715201,93459870,30720443,62739427,3016820,24089189,6972150,0,5653862
"280",2014-04-06,21396810685,21349986488,132973045,129970159,33554046,96416113,86148848,27683562,58465286,14758548,43706738,3002886,16160029,4050429,0,7473104
"281",2014-04-07,21483012527,21396810685,237413785,234418199,81131165,153287034,151211943,36016101,115195842,28044345,87151497,2995586,12179086,3754431,5e+06,15082584
"282",2014-04-08,21602125568,21483012527,360613734,357617701,89382131,268235570,241500693,52832661,188668032,54277033,134390999,2996033,19191402,14549476,210000,18881783
"283",2014-04-09,21765597286,21602125568,465391689,462366980,268861645,193505335,301919971,51749244,250170727,41006108,209164619,3024709,10712976,22667991,0,18368277
"284",2014-04-10,21798843366,21765597286,325897532,322872523,91475729,231396794,292651452,58010842,234640610,35623569,199017041,3025009,23950267,17447091,0,16613484
"285",2014-04-11,21810968272,21798843366,275556141,272526479,77769185,194757294,263431235,55341286,208089949,34977035,173112914,3029662,28855404,5043058,7500000,13942824
"286",2014-04-12,21832155955,21810968272,198643801,195606525,97234354,98372171,177456118,43034611,134421507,27515917,106905590,3037276,15051872,6582401,5010000,16390338
"287",2014-04-13,21835124900,21832155955,202424482,199402640,95464096,103938544,199455537,39100697,160354840,19667340,140687500,3021842,18100249,9153043,0,11847405
"288",2014-04-14,21878561357,21835124900,359340606,356348113,121302823,235045290,315904149,43030155,272873994,32824302,240049692,2992493,17553628,10479584,4010000,10986943
"289",2014-04-15,21882358394,21878561357,337278983,334299471,103712979,230586492,333481946,61840815,271641131,32279051,239362080,2979512,22698925,17788959,6e+06,15352931
"290",2014-04-16,21968232108,21882358394,344518277,341510561,111379811,230130750,258644563,47231064,211413499,54124000,157289499,3007716,6241403,7865970,2500000,30623691
"291",2014-04-17,21977346482,21968232108,268273324,265274821,81673754,183601067,259158950,36285872,222873078,36029263,186843815,2998503,6934074,13530844,4550000,11270954
"292",2014-04-18,22061818641,21977346482,297030419,294027268,141120352,152906916,212558260,48979754,163578506,34102664,129475842,3003151,16917395,19360713,210000,12491646
"293",2014-04-19,22031746557,22061818641,131860659,128849653,48715063,80134590,161932743,27913459,134019284,35666382,98352902,3011006,15185824,4539874,1e+05,8087761
"294",2014-04-20,22018227284,22031746557,161634908,158634541,52549297,106085244,175154181,41710210,133443971,30173059,103270912,3000367,13465226,12286032,3200000,12758952
"295",2014-04-21,21983114148,22018227284,381369739,378379862,199874927,178504935,416482875,52056608,364426267,47910124,316516143,2989877,18280066,13229475,5200000,15347067
"296",2014-04-22,21921441810,21983114148,268322472,265367131,92232320,173134811,329994810,63112441,266882369,25660591,241221778,2955341,32042647,10747710,1e+06,19322084
"297",2014-04-23,21894735137,21921441810,262963640,260006924,106429735,153577189,289670313,58022592,231647721,37170254,194477467,2956716,30223638,16079625,511300,11208029
"298",2014-04-24,21749568261,21894735137,203798291,200874500,77416167,123458333,348965167,47029210,301935957,34586838,267349119,2923791,16578849,16284323,0,14166038
"299",2014-04-25,21838433399,21749568261,320373050,317477961,159662604,157815357,231507912,55003379,176504533,32297349,144207184,2895089,36506352,6240274,1e+06,11256753
"300",2014-04-26,21912634384,21838433399,184640194,181748106,66218712,115529394,110439209,36196928,74242281,22521573,51720708,2892088,19272555,6200251,20000,10704122
"301",2014-04-27,21838953129,21912634384,167611543,164726335,74628929,90097406,241292798,36969196,204323602,17198899,187124703,2885208,21630026,5234945,20100,10084125
"302",2014-04-28,21710521862,21838953129,285236269,282350858,91407032,190943826,413667536,56004461,357663075,39506368,318156707,2885411,25315650,14821585,0,15867226
"303",2014-04-29,21673376129,21710521862,303772841,300911064,88108829,212802235,340918574,40811685,300106889,34465537,265641352,2861777,13204474,11224346,2500000,13882865
"304",2014-04-30,21631048967,21673376129,232262878,229374222,60524631,168849591,274590040,45568959,229021081,56711171,172309910,2888656,24397027,8946355,0,12225577
"305",2014-05-01,21715059287,21631048967,197451051,194592153,46441362,148150791,113440731,34465731,78975000,20094138,58880862,2858898,19837816,5065897,0,9562018
"306",2014-05-02,21741658648,21715059287,129869154,126996537,45053919,81942618,103269793,35465389,67804404,21501101,46303303,2872617,14730436,9404103,0,11330850
"307",2014-05-03,21796837765,21741658648,229609301,226723871,109652282,117071589,174430184,45548968,128881216,23760498,105120718,2885430,20116397,12037443,0,13395128
"308",2014-05-04,21811941798,21796837765,297192156,294283973,103563013,190720960,282088123,54229182,227858941,37486791,190372150,2908183,23827803,16550627,0,13850752
"309",2014-05-05,21913009056,21811941798,425987710,423144977,183979425,239165552,324920452,51719305,273201147,46696002,226505145,2842733,16956930,9632967,11500000,13629408
"310",2014-05-06,21940558852,21913009056,323536443,320597506,92410654,228186852,295986647,58180644,237806003,45139572,192666431,2938937,22041981,17004701,50000,19083962
"311",2014-05-07,22125211598,21940558852,406395515,403499222,206011476,197487746,221742769,46647505,175095264,30262843,144832421,2896293,19653168,10230640,0,16763697
"312",2014-05-08,22211021736,22125211598,353562072,350691463,110240250,240451213,267751934,66484951,201266983,31753789,169513194,2870609,30166940,20595523,0,15722488
"313",2014-05-09,22318020132,22211021736,265472393,262576673,77408385,185168288,158473997,65477551,92996446,22596963,70399483,2895720,30613338,17583670,1e+06,16280543
"314",2014-05-10,22287197742,22318020132,227672886,224780370,52310029,172470341,258495276,21385143,237110133,33251580,203858553,2892516,9656671,4542812,0,7185660
"315",2014-05-11,22352707076,22287197742,208480221,205613906,72213944,133399962,142970887,32032117,110938770,24183657,86755113,2866315,17109450,4664196,0,10258471
"316",2014-05-12,22299502577,22352707076,285228437,282379198,65145785,217233413,338432936,67706618,270726318,42540112,228186206,2849239,30842573,14785910,1400000,20678135
"317",2014-05-13,22411530769,22299502577,362372059,359542926,173798540,185744386,250343867,53368566,196975301,44730491,152244810,2829133,30785652,9236129,20000,13326785
"318",2014-05-14,22404248169,22411530769,290208996,287346732,89139569,198207163,297491596,49220603,248270993,44791851,203479142,2862264,23277922,12219497,0,13723184
"319",2014-05-15,22272285604,22404248169,303286621,300418119,98282350,202135769,435249186,57474778,377774408,48592937,329181471,2868502,18430402,21564216,4e+06,13480160
"320",2014-05-16,22326419973,22272285604,254644568,251791080,93504492,158286588,200510199,37074475,163435724,41434051,122001673,2853488,8700022,12308245,2500000,13566208
"321",2014-05-17,22263117212,22326419973,116291491,113462909,31017593,82445316,179594252,32023295,147570957,37665200,109905757,2828582,12608950,10374250,20000,9020095
"322",2014-05-18,22278734696,22263117212,161097108,158281792,54370770,103911022,145479624,22931933,122547691,23653281,98894410,2815316,10661140,3287193,0,8983600
"323",2014-05-19,22204351254,22278734696,347718384,344813917,184626582,160187335,422101826,57507096,364594730,44258037,320336693,2904467,21482112,16531999,6e+06,13492985
"324",2014-05-20,22293860222,22204351254,286615315,283716907,86302630,197414277,197106347,53331297,143775050,41224813,102550237,2898408,20880366,13317145,0,19133786
"325",2014-05-21,22242490808,22293860222,241015636,238104098,60631883,177472215,292385050,46306331,246078719,25847488,220231231,2911538,26926571,9106176,9e+05,9373584
"326",2014-05-22,22220249424,22242490808,273390048,270554719,106096588,164458131,295631432,61774549,233856883,37763931,196092952,2835329,28799920,14476331,1530000,16968298
"327",2014-05-23,22196423713,22220249424,200156003,197344058,71926493,125417565,223981714,68836445,155145269,34027470,121117799,2811945,27266131,11049692,1.6e+07,14520622
"328",2014-05-24,22104758931,22196423713,141641047,138893414,58147479,80745935,233305829,36610771,196695058,27853903,168841155,2747633,16892954,7956520,0,11761297
"329",2014-05-25,22127380380,22104758931,169866612,167141514,68472420,98669094,147245163,55216982,92028181,18600201,73427980,2725098,25008975,14230179,5e+05,15477828
"330",2014-05-26,21979005861,22127380380,266803815,264091068,88459119,175631949,415178334,47477501,367700833,42491735,325209098,2712747,14539653,11093785,2600000,19244063
"331",2014-05-27,21859681877,21979005861,249676185,246980696,78864038,168116658,369000169,61722166,307278003,35085315,272192688,2695489,28593735,11463955,4310000,17354476
"332",2014-05-28,21746827077,21859681877,268930576,266206185,103588698,162617487,381785376,75372323,306413053,39625560,266787493,2724391,24128835,14842504,1.5e+07,21400984
"333",2014-05-29,21683924883,21746827077,339227554,336568574,188699697,147868877,402129748,45603293,356526455,37279842,319246613,2658980,19317545,8793414,1e+05,17392334
"334",2014-05-30,21656296837,21683924883,248860973,246116690,71543190,174573500,276489019,52268224,224220795,62421522,161799273,2744283,15609333,10216327,8650000,17792564
"335",2014-05-31,21631441535,21656296837,128370165,125719916,49850395,75869521,153225467,41238339,111987128,26383012,85604116,2650249,15407603,12391224,0,13439512
"336",2014-06-01,21664307206,21631441535,143942297,141305877,46281740,95024137,111076626,35012427,76064199,27018856,49045343,2636420,21781519,3209670,0,10021238
"337",2014-06-02,21683668780,21664307206,176770324,174155696,52939866,121215830,157408750,47806711,109602039,26620295,82981744,2614628,21547289,9760500,4e+05,16098922
"338",2014-06-03,21596908720,21683668780,285424724,282767723,80194239,202573484,372184784,91075411,281109373,44628377,236480996,2657001,38918045,16099866,16500000,19557500
"339",2014-06-04,21545545249,21596908720,275697613,273009450,98008894,175000556,327061084,51251768,275809316,57917192,217892124,2688163,20034594,10738907,1500000,18978267
"340",2014-06-05,21551704053,21545545249,309000179,306273120,95105640,211167480,302841375,91975048,210866327,47132866,163733461,2727059,20534039,16690019,33800000,20950990
"341",2014-06-06,21590289071,21551704053,255880246,253226237,97207492,156018745,217295228,42195088,175100140,38208795,136891345,2654009,17768198,10690740,1150000,12586150
"342",2014-06-07,21539265430,21590289071,155141863,152480179,64702829,87777350,206165504,34982787,171182717,37411458,133771259,2661684,12440252,9712400,1580000,11250135
"343",2014-06-08,21540333433,21539265430,181144835,178500500,46674372,131826128,180076832,29928354,150148478,18858094,131290384,2644335,12861137,9465295,0,7601922
"344",2014-06-09,21741608564,21540333433,442360742,439678806,265705014,173973792,241085611,42476153,198609458,38750701,159858757,2681936,16456271,14166682,1e+06,10853200
"345",2014-06-10,21849107626,21741608564,389636668,386974037,142387982,244586055,282137606,42799380,239338226,38975392,200362834,2662631,15689030,11010400,1100000,14999950
"346",2014-06-11,21883060272,21849107626,311384505,308654052,105595606,203058446,277431859,48297113,229134746,32844675,196290071,2730453,18617143,13166544,2950000,13563426
"347",2014-06-12,21894083973,21883060272,267188252,264465153,74061423,190403730,256164551,67082259,189082292,34787911,154294381,2723099,26829011,6285077,15210000,18758171
"348",2014-06-13,21865979480,21894083973,256177180,253408520,77142018,176266502,284281673,49797727,234483946,34483225,200000721,2768660,19044694,13758387,1600000,15394646
"349",2014-06-14,21724708585,21865979480,148539864,145799236,36495168,109304068,289810759,34873423,254937336,21758549,233178787,2740628,14132025,11472189,0,9269209
"350",2014-06-15,21708715582,21724708585,201999390,199289252,66318394,132970858,217992393,26125949,191866444,33749656,158116788,2710138,9326541,3955510,5e+05,12343898
"351",2014-06-16,21661669574,21708715582,336917078,334246981,76922165,257324816,383963086,43236900,340726186,34856616,305869570,2670097,12295815,15848496,0,15092589
"352",2014-06-17,21654852779,21661669574,324524255,321900477,130297150,191603327,331341050,56928812,274412238,26071526,248340712,2623778,12542358,27392141,5e+05,16494313
"353",2014-06-18,21562359897,21654852779,266480068,263869775,63762605,200107170,358972950,39981944,318991006,44880286,274110720,2610293,7741049,14367956,0,17872939
"354",2014-06-19,21522851356,21562359897,282577514,280036838,109211019,170825819,322086055,40446976,281639079,46945032,234694047,2540676,11317116,12295541,1e+06,15834319
"355",2014-06-20,21416602504,21522851356,226974141,224355447,60006116,164349331,333222993,43431926,289791067,27642466,262148601,2618694,16042285,8363113,4200000,14826528
"356",2014-06-21,21433901758,21416602504,186364721,183871019,59117998,124753021,169065467,51788370,117277097,33282562,83994535,2493702,20392710,8861130,110000,22424530
"357",2014-06-22,21345275274,21433901758,143403001,140921885,46237389,94684496,232029485,50148803,181880682,31775999,150104683,2481116,22431653,11328610,0,16388540
"358",2014-06-23,21204941111,21345275274,304220528,301748246,117716992,184031254,444554691,62375762,382178929,57442623,324736306,2472282,29943154,9652173,0,22780435
"359",2014-06-24,21160639430,21204941111,298405851,295946977,137428529,158518448,342707532,74553377,268154155,38664847,229489308,2458874,28899977,13098592,13900000,18654808
"360",2014-06-25,21112616062,21160639430,271335080,268960689,89085680,179875009,319358448,65686453,253671995,39399658,214272337,2374391,36272385,7892452,3300000,18221616
"361",2014-06-26,20838041732,21112616062,223576983,221248791,54342194,166906597,498151313,64893079,433258234,33655681,399602553,2328192,25521288,15339664,3300000,20732127
"362",2014-06-27,20717220690,20838041732,186455771,184105502,60876507,123228995,307276813,54751201,252525612,36280391,216245221,2350269,24448942,13199388,1e+06,16102871
"363",2014-06-28,20699036555,20717220690,181197896,178890260,81008319,97881941,199382031,40204384,159177647,36003153,123174494,2307636,16547385,9272514,8e+05,13584485
"364",2014-06-29,20632047549,20699036555,171945311,169653783,64217255,105436528,238934317,55910425,183023892,39332049,143691843,2291528,23387837,15017402,220000,17285186
"365",2014-06-30,20537915898,20632047549,331665096,329391407,136409714,192981693,425796747,66081134,359715613,58100261,301615352,2273689,30564569,19665703,0,15850862
"366",2014-07-01,20558791735,20537915898,379361211,377030480,108179134,268851346,358485374,52770671,305714703,52553472,253161231,2330731,25781168,12131031,2000,14856472
"367",2014-07-02,20495785749,20558791735,301263008,298967549,96852379,202115170,364268994,87683733,276585261,82997473,193587788,2295459,31915974,16303506,20970000,18494253
"368",2014-07-03,20443186834,20495785749,205360896,203068918,73747793,129321125,257959811,55811016,202148795,42490792,159658003,2291978,26434090,11400726,6300000,11676200
"369",2014-07-04,20411184847,20443186834,221546458,219278476,64846456,154432020,253548445,53111986,200436459,43352775,157083684,2267982,17187833,15135390,8930000,11858763
"370",2014-07-05,20405030486,20411184847,162447667,160184753,59249019,100935734,168602028,35573436,133028592,40188231,92840361,2262914,10558728,14521102,0,10493606
"371",2014-07-06,20317667474,20405030486,163090528,160840529,50982227,109858302,250453540,62404245,188049295,35527175,152522120,2249999,25441151,26063472,3e+05,10599622
"372",2014-07-07,20315307256,20317667474,330300280,328069586,106970841,221098745,332660498,58747518,273912980,38488891,235424089,2230694,24404377,19872746,1800000,12670395
"373",2014-07-08,20189176488,20315307256,237821679,235610197,69898218,165711979,363952447,51005384,312947063,51457710,261489353,2211482,21485115,11049045,2e+06,16471224
"374",2014-07-09,20134473425,20189176488,254180106,251952861,72225309,179727552,308883169,36052975,272830194,40623821,232206373,2227245,12213885,10147017,0,13692073
"375",2014-07-10,20089376395,20134473425,277110154,274863005,88597264,186265741,322207184,56261390,265945794,48574648,217371146,2247149,32278026,9707364,1001000,13275000
"376",2014-07-11,20056488834,20089376395,233743113,231524466,70283598,161240868,266630674,46358673,220272001,41530775,178741226,2218647,19218201,15294811,3e+05,11545661
"377",2014-07-12,20032588018,20056488834,149584303,147378554,54194528,93184026,173485119,30543948,142941171,24010717,118930454,2205749,8927374,11303010,3e+05,10013564
"378",2014-07-13,19956858850,20032588018,142610813,140419081,36671224,103747857,218339981,60898752,157441229,37037506,120403723,2191732,25078430,19150402,0,16669920
"379",2014-07-14,19930774100,19956858850,246080213,243874439,80550393,163324046,272164963,46665267,225499696,52997168,172502528,2205774,14848391,15472276,1e+05,16244600
"380",2014-07-15,19860676965,19930774100,299355385,297144434,105010178,192134256,369452520,55093139,314359381,59556107,254803274,2210951,19577469,15814235,6600000,13101435
"381",2014-07-16,19859342530,19860676965,277080654,274854918,97542517,177312401,278415089,45501005,232914084,49435683,183478401,2225736,14748543,14797528,320000,15634934
"382",2014-07-17,19909238452,19859342530,254493213,252314385,62896668,189417717,204597291,52553110,152044181,44327205,107716976,2178828,12769322,7890466,20681400,11211922
"383",2014-07-18,19938351258,19909238452,191967546,189764915,80157267,109607648,162854740,48380762,114473978,41063739,73410239,2202631,21301772,12257315,280000,14541675
"384",2014-07-19,19969476627,19938351258,153934641,151737310,68931331,82805979,122809272,32079738,90729534,23563180,67166354,2197331,10352004,9215539,0,12512195
"385",2014-07-20,19985814744,19969476627,174324225,172136318,71389843,100746475,157986108,42634052,115352056,32983262,82368794,2187907,17591422,14662451,0,10380179
"386",2014-07-21,19902050427,19985814744,241509367,239271655,61626994,177644661,325273684,64507735,260765949,43783488,216982461,2237712,35095214,16439916,0,12972605
"387",2014-07-22,19816838583,19902050427,222479621,220308003,71232428,149075575,307691465,81424302,226267163,37991700,188275463,2171618,26848727,16729812,24200042,13645721
"388",2014-07-23,19809654004,19816838583,281820273,279613501,119974077,159639424,289004852,62095242,226909610,42856156,184053454,2206772,30673255,12295315,5810000,13316672
"389",2014-07-24,19782695385,19809654004,257332381,255142468,93632247,161510221,284291000,74440553,209850447,47067956,162782491,2189913,34726889,18879779,3900000,16933885
"390",2014-07-25,19753087271,19782695385,203397102,201199683,71674437,129525246,233005216,52138371,180866845,32373389,148493456,2197419,21268427,16257422,7e+05,13912522
"391",2014-07-26,19799381693,19753087271,198457820,196264944,80187175,116077769,152163398,32435138,119728260,30975736,88752524,2192876,15463615,8291873,760000,7919650
"392",2014-07-27,19680036420,19799381693,162389176,160207880,43770749,116437131,281734449,51783449,229951000,31127681,198823319,2181296,24879848,9096708,5200000,12606893
"393",2014-07-28,19539516506,19680036420,253136439,250965518,67068113,183897405,393656353,73549980,320106373,43257800,276848573,2170921,40360126,11322980,7030000,14836874
"394",2014-07-29,19679699850,19539516506,325692942,323567142,153156443,170410699,185509598,58228687,127280911,27407675,99873236,2125800,21002108,19155454,0,18071125
"395",2014-07-30,19640734715,19679699850,239088792,236928575,71955371,164973204,278053927,52702326,225351601,48912205,176439396,2160217,21477041,19078299,1e+06,11146986
"396",2014-07-31,19599162817,19640734715,228056623,225892609,63266187,162626422,269628521,56674409,212954112,46561197,166392915,2164014,24697494,14549005,4930000,12497910
"397",2014-08-01,19694811620,19599162817,378242546,376078642,178003301,198075341,282593743,56024808,226568935,45105842,181463093,2163904,14903966,20916584,3900000,16304258
"398",2014-08-02,19684841456,19694811620,152120792,149959472,51225714,98733758,162090956,50319415,111771541,22486649,89284892,2161320,12105932,10003628,2e+07,8209855
"399",2014-08-03,19717753478,19684841456,154077981,151927198,40390693,111536505,121165959,30525657,90640302,22556695,68083607,2150783,14118616,6024489,0,10382552
"400",2014-08-04,19723967507,19717753478,254890053,252691918,64342298,188349620,248676024,45231380,203444644,48248858,155195786,2198135,22692036,12212460,0,10326884
"401",2014-08-05,19757175209,19723967507,311680953,309522530,107215559,202306971,278473251,69572167,208901084,35611163,173289921,2158423,30183071,25100814,8e+05,13488282
"402",2014-08-06,19778605094,19757175209,269143684,266973252,84145614,182827638,247713799,63965312,183748487,39760522,143987965,2170432,24218854,19465955,5100000,15180503
"403",2014-08-07,19751273461,19778605094,256485155,254304179,78885774,175418405,283816788,89057693,194759095,31543121,163215974,2180976,25364640,30432989,23840000,9420064
"404",2014-08-08,19774980321,19751273461,228097887,225877171,51742096,174135075,204391027,46502917,157888110,47061470,110826640,2220716,14056132,15089438,3e+06,14357347
"405",2014-08-09,19778112596,19774980321,146751994,144568113,43984613,100583500,143619719,45363365,98256354,38409045,59847309,2183881,20895726,11927799,4e+06,8539840
"406",2014-08-10,19718661160,19778112596,164174384,162000836,63784639,98216197,223625820,40250201,183375619,40402946,142972673,2173548,10934924,14753570,1e+05,14461707
"407",2014-08-11,19617460970,19718661160,284695009,282526307,61108709,221417598,385895199,91149319,294745880,44496700,250249180,2168702,31647415,30408670,15100000,13993234
"408",2014-08-12,19623908461,19617460970,260705801,258571271,74299566,184271705,254258310,67521707,186736603,31759110,154977493,2134530,26417544,24572383,4e+06,12531780
"409",2014-08-13,19577313188,19623908461,262139305,259982210,59905552,200076658,308734578,64371557,244363021,35811622,208551399,2157095,28048638,20420627,3e+05,15602292
"410",2014-08-14,19573505127,19577313188,248894735,246698527,107713702,138984825,252702796,48316222,204386574,38584333,165802241,2196208,10465885,18607985,506999,18735353
"411",2014-08-15,19621378538,19573505127,268968079,266817966,86347807,180470159,221094668,45357483,175737185,55512991,120224194,2150113,14142068,14674216,5100000,11441199
"412",2014-08-16,19621134576,19621378538,158553438,156400385,34148707,122251678,158797400,44660499,114136901,47925261,66211640,2153053,16006366,11433225,1e+05,17120908
"413",2014-08-17,19587953252,19621134576,161198309,159056260,51930834,107125426,194379633,49868293,144511340,53782975,90728365,2142049,16953025,15320901,30000,17564367
"414",2014-08-18,19482545871,19587953252,280533543,278402961,101054212,177348749,385940924,76744528,309196396,37757010,271439386,2130582,24096725,29037115,2030000,21580688
"415",2014-08-19,19470894099,19482545871,236052637,233917461,72812321,161105140,247704409,69957693,177746716,22381798,155364918,2135176,19785896,18066286,2e+06,30105511
"416",2014-08-20,19435379292,19470894099,209205785,207044209,72512776,134531433,244720592,68385767,176334825,24395024,151939801,2161576,14778500,16850821,1270000,35486446
"417",2014-08-21,19484201053,19435379292,234392568,232246439,45250145,186996294,185570807,63720372,121850435,19206246,102644189,2146129,13196024,16066483,8620000,25837865
"418",2014-08-22,19433856126,19484201053,182566127,180442519,51463218,128979301,232911054,66045065,166865989,28982270,137883719,2123608,16656825,22104560,315000,26968680
"419",2014-08-23,19391689432,19433856126,154613502,152496539,55378894,97117645,196780196,68686292,128093904,21499110,106594794,2116963,25058356,14137957,502687,28987292
"420",2014-08-24,19315945046,19391689432,134164401,132062640,47480609,84582031,209908787,62938356,146970431,15475921,131494510,2101761,26412561,9744670,2e+05,26581125
"421",2014-08-25,19334568604,19315945046,283116043,281007169,89335966,191671203,264492485,90208886,174283599,28782407,145501192,2108874,43815694,14263221,3060000,29069971
"422",2014-08-26,19304389297,19334568604,241046273,238954926,52865657,186089269,271225580,90976322,180249258,36176834,144072424,2091347,32686970,8742915,3610000,45936437
"423",2014-08-27,19186255088,19304389297,227515169,225403850,53448483,171955367,345649378,102513613,243135765,23392440,219743325,2111319,24079498,20471246,14780000,43182869
"424",2014-08-28,19099357862,19186255088,240376956,238283118,60812198,177470920,327274182,99013812,228260370,26625517,201634853,2093838,33664638,25545748,1370000,38433426
"425",2014-08-29,18954277524,19099357862,214114844,212008155,56975962,155032193,359195182,71837074,287358108,35917333,251440775,2106689,14506235,21229508,4960000,31141331
"426",2014-08-30,18936064993,18954277524,183547267,181447940,46668562,134779378,201759798,71478805,130280993,11964050,118316943,2099327,17784770,19436621,1140366,33117048
"427",2014-08-31,18982271775,18936064993,205369438,203285812,53660539,149625273,159162656,61184060,97978596,30600851,67377745,2083626,13658334,15598353,1230000,30697373
