20130701,700481397,635435618,89813113,89740476,50079487,39660989,24767334,2512676,22254658,22254658,0,72637,0,41960,0,2470716
20130702,812904944,700481397,120814358,120737663,91480675,29256988,8390811,2035277,6355534,6355534,0,76695,0,28850,0,2006427
20130703,895489501,812904944,99830106,99728701,72957690,26771011,17245549,1260157,15985392,15985392,0,101405,0,67918,0,1192239
20130704,1024531538,895489501,145901690,145788886,111287821,34501065,16859653,2897939,13961714,13961714,0,112804,460196,314701,0,2123042
20130705,1097936127,1024531538,84773760,84651915,59434750,25217165,11369171,1647557,9721614,9721614,0,121845,2800,537800,0,1106957
20130706,1142591381,1097936127,59506459,59368503,50801816,8566687,14851205,2120136,12731069,12731069,0,137956,203540,671658,0,1244938
20130707,1180619647,1142591381,46789017,46652225,33105677,13546548,8760751,2737053,6023698,6023698,0,136792,911420,439004,0,1386629
20130708,1294890394,1180619647,127070930,126940052,89488265,37451787,12800183,2243235,10556948,10556948,0,130878,361172,357301,0,1524762
20130709,1384191571,1294890394,127045030,126905458,104777704,22127754,37743853,3754426,33989427,33989427,0,139572,403341,2036935,0,1314150
20130710,1462827905,1384191571,94024796,93864424,63901617,29962807,15388462,7194448,8194014,8194014,0,160372,5520949,279600,0,1393899
20130711,1535628212,1462827905,92533829,92361655,66845266,25516389,19733522,2879961,16853561,16853561,0,172174,1085590,289612,0,1504759
20130712,1597553250,1535628212,88590123,88410376,72552182,15858194,26665085,4740078,21925007,21925007,0,179747,905530,1957929,0,1876619
20130713,1557596561,1597553250,44843315,44656726,32447651,12209075,84800004,2336647,82463357,82463357,0,186589,246100,430500,0,1660047
20130714,1633123133,1557596561,95595992,95419415,75707795,19711620,20069420,2245272,17824148,17824148,0,176577,557054,207100,0,1481118
20130715,1762344940,1633123133,154906446,154736504,118908875,35827629,25684639,3094853,22589786,22589786,0,169942,1188070,412707,0,1494076
20130716,1795171224,1762344940,82754720,82573061,54734902,27838159,49928436,5186694,44741742,44741742,0,181659,1169712,37165,0,3979817
20130717,1871094069,1795171224,149091732,148889649,115846441,33043208,73168887,4030369,69138518,69138518,0,202083,1794095,198068,0,2038206
20130718,1993820445,1871094069,148988197,148784128,122438117,26346011,26261821,3047287,23214534,23214534,0,204069,1113116,239528,0,1694643
20130719,2067895653,1993820445,103432155,103210578,80438690,22771888,29356947,3202245,26154702,26154702,0,221577,964427,194760,0,2043058
20130720,2095984539,2067895653,51379255,51144415,32107127,19037288,23290369,1775942,21514427,21514427,0,234840,294904,373450,0,1107588
20130721,2176874786,2095984539,114182489,113949746,93706827,20242919,33292242,2726268,30565974,30565974,0,232743,140991,497991,0,2087286
20130722,2270725761,2176874786,129240030,129016657,95757315,33259342,35389055,5074683,30314372,30314372,0,223373,1872040,790238,0,2412405
20130723,2326808533,2270725761,100023603,99786376,66424515,33361861,43940831,6868640,37072191,37072191,0,237227,3729560,533683,0,2605397
20130724,2390300503,2326808533,124934446,124671788,92346988,32324800,61442476,13771959,47670517,47670517,0,262658,8266400,2707208,0,2798351
20130725,2460017076,2390300503,128615656,128351291,93172158,35179133,58899083,5744574,53154509,53154509,0,264365,2519203,1141128,0,2084243
20130726,2517567871,2460017076,106171544,105897498,84619706,21277792,48620749,3901717,44719032,44719032,0,274046,1574273,118850,0,2208594
20130727,2566587771,2517567871,73916277,73633985,51927633,21706352,24896377,10039482,14856895,14856895,0,282292,1377185,6755442,0,1906855
20130728,2605555005,2566587771,62626554,62343184,48317046,14026138,23659320,3814949,19844371,19844371,0,283370,1218004,193657,0,2403288
20130729,2707232066,2605555005,165363143,165085871,132451136,32634735,63686082,8139948,55546134,55546134,0,277272,1464508,3612958,0,3062482
20130730,2862635655,2707232066,191812968,191522453,163435646,28086807,36409379,4824576,31584803,31584803,0,290515,1156531,1059361,0,2608684
20130731,2948588589,2862635655,138901835,138579564,107549991,31029573,52948901,9452190,43496711,43496711,0,322271,4263199,607440,0,4581551
20130801,3115460247,2948588589,225245595,224908265,186126761,38781504,58373937,5360839,53013098,53013098,0,337330,1959214,512881,0,2888744
20130802,3193941185,3115460247,155842960,155489848,122298355,33191493,77362022,6076088,71285934,71285934,0,353112,2592184,54200,0,3429704
20130803,3241846740,3193941185,75439704,75071145,53669636,21401509,27534149,4157439,23376710,23376710,0,368559,1278800,229883,0,2648756
20130804,3290898516,3241846740,72586562,72219464,55254297,16965167,23534786,5249835,18284951,18284951,0,367098,1009099,616881,0,3623855
20130805,3444289782,3290898516,211681418,211323628,166997438,44326190,58290152,5126715,53163437,53163437,0,357790,980076,989809,0,3156830
20130806,3551550634,3444289782,173791518,173417598,127254521,46163077,66530666,10455357,56075309,56075309,0,373920,5481998,1359673,0,3613686
20130807,3636576532,3551550634,148706998,148297903,108641447,39656456,63681100,9120459,54560641,54560641,0,409095,5904317,591586,0,2624556
20130808,3743890011,3636576532,166870967,166447347,106229566,60217781,59557488,7954347,51603141,51603141,0,423620,2784311,1917753,0,3252283
20130809,3790309326,3743890011,125302842,124867777,87658632,37209145,78883527,10882478,68001049,68001049,0,435065,6476286,1217220,0,3188972
20130810,3799083370,3790309326,71389165,70945207,52285877,18659330,62615121,4649430,57965691,57965691,0,443958,1570231,892341,0,2186858
20130811,3855455121,3799083370,97747045,97307675,71143484,26164191,41375294,5186505,36188789,36188789,0,439370,2381458,962299,0,1842748
20130812,3929244636,3855455121,167976431,167548770,132178169,35370601,94186916,7512527,86674389,86674389,0,427661,2052911,1010912,0,4448704
20130813,4058974395,3929244636,209288691,208847375,164312771,44534604,79558932,5919599,73639333,73639333,0,441316,1828607,1374274,0,2716718
20130814,4182496781,4058974395,179540557,179071117,139371002,39700115,56018171,5130231,50887940,50887940,0,469440,1953697,678113,0,2498421
20130815,4197177606,4182496781,137756016,137268818,84091765,53177053,123075191,6392218,116682973,116682973,0,487198,3096824,962611,0,2332783
20130816,4302861402,4197177606,160827399,160332006,105956011,54375995,55143603,3955600,51188003,51188003,0,495393,726486,576523,0,2652591
20130817,4347191112,4302861402,74614450,74110862,39443043,34667819,30284740,3903303,26381437,26381437,0,503588,479646,618572,0,2805085
20130818,4382930884,4347191112,102665299,102163213,74569532,27593681,66925527,9412507,57513020,45314779,12198241,502086,1480444,5341962,0,2590101
20130819,4498528228,4382930884,191034645,190541995,144888653,45653342,75437301,8311781,67125520,57618402,9507118,492650,4191725,504160,0,3615896
20130820,4659721247,4498528228,215278887,214765021,163701984,51063037,54085868,7377832,46708036,45107613,1600423,513866,1694116,2053827,0,3629889
20130821,4775305750,4659721247,179538060,178990631,128380345,50610286,63953557,8472124,55481433,45083443,10397990,547429,3536266,1277695,0,3658163
20130822,4839006742,4775305750,141263728,140704141,113057591,27646550,77562736,13611258,63951478,44866641,19084837,559587,8104045,2026803,0,3480410
20130823,4932606239,4839006742,170467134,169893175,139227755,30665420,76867637,9631137,67236500,36950469,30286031,573959,4816221,1603311,0,3211605
20130824,4983785691,4932606239,90286330,89705569,65033754,24671815,39106878,7047256,32059622,20758390,11301232,580761,3768536,498938,0,2779782
20130825,5025320057,4983785691,102488268,101911521,75148528,26762993,60953902,6473754,54480148,30183609,24296539,576747,3075735,777325,0,2620694
20130826,5121561415,5025320057,170342886,169788188,129961672,39826516,74101528,8217665,65883863,33524894,32358969,554698,4463025,998720,0,2755920
20130827,5224782039,5121561415,201065197,200481110,154478081,46003029,97844573,10471882,87372691,47884022,39488669,584087,4945695,1057900,0,4468287
20130828,5217793287,5224782039,129007472,128398918,88448548,39950370,135996224,14563457,121432767,88488237,32944530,608554,9341916,1351527,0,3870014
20130829,5215130709,5217793287,123008333,122337780,81144606,41193174,125670911,8730072,116940839,59146266,57794573,670553,5166652,937304,0,2626116
20130830,5331420667,5215130709,167352846,166634914,123753968,42880946,51062888,9407781,41655107,28024312,13630795,717932,2814484,3900962,0,2692335
20130831,5366695981,5331420667,105053756,104425086,71098178,33326908,69778442,9925405,59853037,46663780,13189257,628670,4331436,2572483,0,3021486
20130901,5436775866,5366695981,130597360,129973966,88167002,41806964,60517475,8279390,52238085,17303051,34935034,623394,5180168,476713,0,2622509
20130902,5552963421,5436775866,207386289,206650244,146818340,59831904,91198734,17744722,73454012,21538712,51915300,736045,7537784,6521695,0,3685243
20130903,5602828386,5552963421,172090108,171453215,118030421,53422794,122225143,11152269,111072874,66507281,44565593,636893,4709761,1375934,0,5066574
20130904,5762777806,5602828386,246685377,246014993,191259216,54755777,86735957,10616809,76119148,27184342,48934806,670384,2902711,2913212,0,4800886
20130905,5864004058,5762777806,193869240,193187515,134138483,59049032,92642988,13789351,78853637,34267589,44586048,681725,5171539,2306940,0,6310872
20130906,5917078681,5864004058,176731156,175877625,132519397,43358228,123656533,21461331,102195202,61198746,40996456,853531,5549412,10663759,0,5248160
20130907,5951981951,5917078681,102583538,101871888,64442191,37429697,67680268,10426615,57253653,18735171,38518482,711650,4610850,1322198,0,4493567
20130908,5981510226,5951981951,98918622,98216046,51091308,47124738,69390347,16793074,52597273,28821416,23775857,702576,11165577,973722,0,4653775
20130909,6058535460,5981510226,213520532,212709425,143563435,69145990,136495298,12668829,123826469,43906785,79919684,811107,3169303,4432425,0,5067101
20130910,6217169178,6058535460,235334890,234526540,143150589,91375951,76701172,14219361,62481811,22723950,39757861,808350,7131837,1425277,0,5662247
20130911,6247431899,6217169178,156030112,155280792,87837138,67443654,125767391,10267383,115500008,50464735,65035273,749320,4799747,1672439,0,3795197
20130912,6374257159,6247431899,200890607,200123710,136378378,63745332,74065347,10743389,63321958,22046743,41275215,766897,4129785,1867236,0,4746368
20130913,6425847100,6374257159,138108652,137257146,72812697,64444449,86518711,11363588,75155123,37967618,37187505,851506,4191996,2524892,0,4646700
20130914,6442534381,6425847100,98337797,97545494,50510665,47034829,81650516,11029748,70620768,29276721,41344047,792303,6553545,572849,0,3903354
20130915,6482997330,6442534381,130360305,129576058,88992296,40583762,89897356,12914219,76983137,20445301,56537836,784247,5204873,4001409,0,3707937
20130916,6608798109,6482997330,244970979,244099599,170561469,73538130,119170200,8098987,111071213,40832758,70238455,871380,2172128,1336842,0,4590017
20130917,6692013451,6608798109,205792163,205019506,132853023,72166483,122576821,10864096,111712725,30073707,81639018,772657,4492342,1860516,0,4511238
20130918,6774046505,6692013451,165970416,165103564,93782467,71321097,83937362,16405460,67531902,31439597,36092305,866852,9358737,1331269,0,5715454
20130919,6820862302,6774046505,90641505,89810079,62402006,27408073,43825708,9240889,34584819,15472520,19112299,831426,4863994,1210326,0,3166569
20130920,6817088855,6820862302,78211465,77365817,47096586,30269231,81984912,10939799,71045113,26466121,44578992,845648,6249425,568403,0,4121971
20130921,6884965164,6817088855,114655993,113810330,72720587,41089743,46779684,10753663,36026021,14665661,21360360,845663,6457467,997566,0,3298630
20130922,7035197668,6884965164,229705941,228865365,144842942,84022423,79473437,14198200,65275237,25228398,40046839,840576,6791360,1324500,0,6082340
20130923,7120027836,7035197668,215173883,214355202,126781094,87574108,130343715,18667855,111675860,48781386,62894474,818681,10455356,2181962,0,6030537
20130924,7221958488,7120027836,220603453,219726362,170695534,49030828,118672801,16168635,102504166,29538399,72965767,877091,6185946,3489645,0,6493044
20130925,7312158229,7221958488,178184987,177213261,96853096,80360165,87985246,24113730,63871516,26181827,37689689,971726,16979079,2334652,0,4799999
20130926,7342854076,7312158229,196326843,195297370,125001520,70295850,165630996,18179875,147451121,63493126,83957995,1029473,9667966,2075577,0,6436332
20130927,7452817005,7342854076,257158567,256171333,176255217,79916116,147195638,16581173,130614465,52867015,77747450,987234,11549204,1526307,0,3505662
20130928,7449922488,7452817005,118852653,117904755,67639950,50264805,121747170,19970887,101776283,40588821,61187462,947898,13785010,1311867,0,4874010
20130929,7455658757,7449922488,161394027,160457423,82540606,77916817,155657758,17059454,138598304,50520282,88078022,936604,10082224,1380490,0,5596740
20130930,7462609366,7455658757,160072281,159150202,89206513,69943689,153121672,20069252,133052420,58737306,74315114,922079,10528905,4363373,0,5176974
20131001,7483754225,7462609366,58411310,57478465,25923483,31554982,37266451,13881973,23384478,8869714,14514764,932845,9551143,1151911,0,3178919
20131002,7497090113,7483754225,54721123,53744118,31669037,22075081,41385235,10763083,30622152,14244817,16377335,977005,6762898,449556,0,3550629
20131003,7519922898,7497090113,64648545,63669608,41112346,22557262,41815760,14934256,26881504,7569156,19312348,978937,9270948,2534247,0,3129061
20131004,7527091243,7519922898,66589920,65609076,43430480,22178596,59421575,10785492,48636083,28937801,19698282,980844,4235895,2413720,0,4135877
20131005,7528348464,7527091243,54212404,53231653,27716517,25515136,52955183,8219009,44736174,16792822,27943352,980751,3034537,1715893,0,3468579
20131006,7543136004,7528348464,70693085,69722842,34138829,35584013,55905545,12291671,43613874,17674723,25939151,970243,7256633,1518216,0,3516822
20131007,7622953322,7543136004,192110784,191146634,126897892,64248742,112293466,19452754,92840712,40208141,52632571,964150,12715486,1638133,0,5099135
20131008,7756967596,7622953322,400213868,399132832,277978136,121154696,266199594,26235947,239963647,114984442,124979205,1081036,14544145,4701929,0,6989873
20131009,7852681163,7756967596,274434171,273475501,150502657,122972844,178720604,17048182,161672422,45108871,116563551,958670,7281013,4461007,0,5306162
20131010,7986019467,7852681163,293972112,292978594,143881903,149096691,160633808,12911135,147722673,76492163,71230510,993518,5168650,1018032,0,6724453
20131011,8137636362,7986019467,289116360,288107493,177921147,110186346,137499465,16274184,121225281,55910477,65314804,1008867,4890574,5253764,0,6129846
20131012,8353071783,8137636362,314468363,313438741,227244469,86194272,99032942,20084772,78948170,36038062,42910108,1029622,12808208,1617995,0,5658569
20131013,8456824086,8353071783,182858328,181837499,100652184,81185315,79106025,27363056,51742969,26373865,25369104,1020829,10752227,11505493,0,5105336
20131014,8758757857,8456824086,417460081,416468724,279808434,136660290,115526310,15347160,100179150,37710921,62468229,991357,5621362,4173216,0,5552582
20131015,8884818956,8758757857,346614200,345548994,217740642,127808352,220553101,19846652,200706449,70488703,130217746,1065206,6794658,4731661,0,8320333
20131016,9135752959,8884818956,363420403,362299021,200731359,161567662,112486400,16022775,96463625,35259295,61204330,1121382,5244318,4352451,0,6426006
20131017,9295510814,9135752959,296070297,294938914,128927220,166011694,136312442,13278410,123034032,48986139,74047893,1131383,6438890,2050393,0,4789127
20131018,9333534837,9295510814,236454735,235292546,132857506,102435040,198430712,23593265,174837447,69274336,105563111,1162189,8608000,8318932,0,6666333
20131019,9456825781,9333534837,198958559,197789953,120679973,77109980,75667615,10966269,64701346,37882331,26819015,1168606,3282308,2274933,0,5409028
20131020,9545287147,9456825781,187152905,185990062,96261019,89729043,98691539,20412350,78279189,29302295,48976894,1162843,10607987,3423486,0,6380877
20131021,9754567626,9545287147,386053376,384847213,236653918,148193295,176772897,22723664,154049233,79332306,74716927,1206163,11187083,5668574,0,5868007
20131022,9994943080,9754567626,355931275,354777836,181516461,173261375,115555821,18936053,96619768,36233480,60386288,1153439,7578898,3310954,0,8046201
20131023,10107112805,9994943080,354289136,353062540,209639408,143423132,242119411,24720352,217399059,54113083,163285976,1226596,13943200,3007565,0,7769587
20131024,10155241727,10107112805,298758783,297509968,149319206,148190762,250629861,28802992,221826869,67942330,153884539,1248815,18272044,2863280,0,7667668
20131025,10267538758,10155241727,267017153,265761152,136392181,129368971,154720122,35393972,119326150,51286554,68039596,1256001,22981724,5516836,0,6895412
20131026,10419612220,10267538758,252249276,250975852,156296163,94679689,100175814,23311238,76864576,29327262,47537314,1273424,8766793,6483087,0,8061358
20131027,10476143609,10419612220,150344030,149077803,69274086,79803717,93812641,14260698,79551943,31524613,48027330,1266227,4256090,3000554,0,7004054
20131028,10631156229,10476143609,459922019,458692111,241433119,217258992,304909399,34604883,270304516,111643697,158660819,1229908,24127816,2497591,0,7979476
20131029,10890204087,10631156229,442440394,441169044,260607313,180561731,183392536,32055409,151337127,45641905,105695222,1271350,11279038,11308337,0,9468034
20131030,11021983128,10890204087,416808511,415461952,194923249,220538703,285029470,17893664,267135806,113767220,153368586,1346559,9336781,2879781,0,5677102
20131031,11106624779,11021983128,317970797,316590294,140069751,176520543,233329146,25120654,208208492,68151394,140057098,1380503,13625433,3593338,0,7901883
20131101,11314248446,11106624779,402779908,401385983,217111962,184274021,195156241,26759890,168396351,83339457,85056894,1393925,13048609,3675053,0,10036228
20131102,11436744284,11314248446,269181203,267772970,121908853,145864117,146685365,35176180,111509185,23554039,87955146,1408233,21099150,5976256,0,8100774
20131103,11558255431,11436744284,274526001,273131240,136991998,136139242,153014854,15522425,137492429,57260011,80232418,1394761,9129757,973270,0,5419398
20131104,11744109844,11558255431,398719844,397334854,233419870,163914984,212865431,39468239,173397192,49794575,123602617,1384990,19755199,11633055,0,8079985
20131105,12001673652,11744109844,552606084,551195618,263221628,287973990,295042276,56457949,238584327,78196123,160388204,1410466,22630449,21740253,0,12087247
20131106,12436065855,12001673652,680731675,679245058,314309970,364935088,246339472,38917950,207421522,59517462,147904060,1486617,20521321,7772714,0,10623915
20131107,12796803048,12436065855,714661126,713130957,273724117,439406840,353923933,49691513,304232420,73776170,230456250,1530169,30496328,6155182,0,13040003
20131108,13114771500,12796803048,599073316,597497852,269812873,327684979,281104864,39300974,241803890,92660707,149143183,1575464,17990203,5664288,0,15646483
20131109,13273920847,13114771500,413232038,411611379,147683178,263928201,254082691,40716439,213366252,85976964,127389288,1620659,19597879,6801673,0,14316887
20131110,13548733328,13273920847,503754820,502147434,179448782,322698652,228942339,48841927,180100412,76167446,103932966,1607386,20064051,5842274,0,22935602
20131111,13359810277,13548733328,568392496,566537962,297041343,269496619,757315547,436614870,320700677,106823791,213876886,1854534,22385566,12635898,86534212,315059194
20131112,13678706520,13359810277,576579651,574766533,322940715,251825818,257683408,50653081,207030327,69571935,137458392,1813118,27403884,5238527,1000000,17010670
20131113,14070974798,13678706520,593090347,591243378,352692727,238550651,200822069,48491293,152330776,47071816,105258960,1846969,13078859,4365472,14000000,17046962
20131114,14318560687,14070974798,488635145,486843645,236870150,249973495,241049256,26650985,214398271,82527255,131871016,1791500,10781595,4497379,0,11372011
20131115,14582550243,14318560687,450794762,448753601,221224073,227529528,186805206,28909794,157895412,57824515,100070897,2041161,10234402,7866338,0,10809054
20131116,14724635400,14582550243,316633052,314781375,146414239,168367136,174547895,33652371,140895524,58553481,82342043,1851677,14749240,7035939,2000000,9867192
20131117,14905107204,14724635400,490372314,488537166,293567922,194969244,309900510,22913676,286986834,149100606,137886228,1835148,9802172,3062675,100000,9948829
20131118,15064185917,14905107204,522189427,520356762,283972179,236384583,363110714,38513410,324597304,134830174,189767130,1832665,14791499,12540657,0,11181254
20131119,15322237928,15064185917,581096699,579221606,273673064,305548542,323044688,42097691,280946997,89882382,191064615,1875093,14773346,12296383,0,15027962
20131120,15599670760,15322237928,574718176,572748916,299891466,272857450,297285344,57759826,239525518,68152936,171372582,1969260,19858223,17272044,0,20629559
20131121,15913998942,15599670760,541676554,539653220,265462272,274190948,227348372,43519365,183829007,48665467,135163540,2023334,21152795,11952089,0,10414481
20131122,16007697841,15913998942,397695765,395618322,198037725,197580597,303996866,49256768,254740098,95958684,158781414,2077443,27091829,11743743,0,10421196
20131123,16186796940,16007697841,369423029,367314671,213783278,153531393,190323930,41635721,148688209,38773534,109914675,2108358,23395053,6221568,0,12019100
20131124,16288594401,16186796940,270526886,268435762,126419820,142015942,168729425,56692932,112036493,32238942,79797551,2091124,35803516,6012795,0,14876621
20131125,16588116321,16288594401,601607369,599495724,243211421,356284303,302085449,54453667,247631782,95845720,151786062,2111645,36588077,5460344,0,12405246
20131126,16890368101,16588116321,550825368,548683487,234472672,314210815,248573588,48315698,200257890,59327165,140930725,2141881,24495987,5103866,100000,18615845
20131127,17078123188,16890368101,506111814,503862944,236935695,266927249,318356727,50170836,268185891,82319932,185865959,2248870,27346188,5740692,0,17083956
20131128,17390031807,17078123188,606820848,604523226,342961045,261562181,294912229,54589974,240322255,53176405,187145850,2297622,34979104,5801765,150781,13658324
20131129,17517941302,17390031807,431776160,429441187,171118479,258322708,303866665,38252396,265614269,106301138,159313131,2334973,20078514,5624428,0,12549454
20131130,17704747955,17517941302,370945332,368571791,242910967,125660824,184138679,39138955,144999724,66534625,78465099,2373541,23679981,4704669,0,10754305
20131201,17923781251,17704747955,468652815,466297710,164914241,301383469,249619519,54607655,195011864,48497410,146514454,2355105,24054759,16933145,0,13619751
20131202,18209387910,17923781251,666056452,663724188,330114288,333609900,380449793,51386011,329063782,101670154,227393628,2332264,19243660,11449620,0,20692731
20131203,18633958634,18209387910,790334435,787974104,393996285,393977819,365763711,60447074,305316637,73714781,231601856,2360331,23066123,16549655,0,20831296
20131204,19044689931,18633958634,653729093,651229505,302014552,349214953,242997796,47948174,195049622,59596228,135453394,2499588,19963174,11696616,0,16288384
20131205,19393185414,19044689931,701257997,698678145,326744665,371933480,352762514,65568769,287193745,93050080,194143665,2579852,35766591,14175922,0,15626256
20131206,19582186766,19393185414,464265102,461674014,194758107,266915907,275263750,53844948,221418802,68937713,152481089,2591088,29292792,9829082,50100,14672974
20131207,19785381912,19582186766,396118837,393475234,167904066,225571168,192923691,43151816,149771875,66863041,82908834,2643603,22003062,6359166,0,14789588
20131208,19963824872,19785381912,457110650,454486767,245489518,208997249,278667690,54502024,224165666,55912916,168252750,2623883,34209736,3110190,20000,17162098
20131209,20064122747,19963824872,568428308,565747973,254020043,311727930,468130433,60380104,407750329,118033449,289716880,2680335,30823513,9083719,500000,19972872
20131210,20420358670,20064122747,722592875,719907759,311067583,408840176,366356952,68442930,297914022,81636255,216277767,2685116,40642534,7123494,10000,20666902
20131211,20714072504,20420358670,674017286,671214184,301495514,369718670,380303452,56114464,324188988,62377605,261811383,2803102,18334023,20181795,100,17598546
20131212,21134539676,20714072504,774488551,771549524,403630614,367918910,354021379,111869556,242151823,94118614,148033209,2939027,29104985,8721905,3640100,70402566
20131213,21500685804,21134539676,615161859,612203803,276006836,336196967,249015731,61740823,187274908,74924112,112350796,2958056,37156343,4418540,3224500,16941440
20131214,21542598158,21500685804,305389352,302358518,91714947,210643571,263476998,49335025,214141973,54387291,159754682,3030834,18415906,11355897,30000,19533222
20131215,21845722117,21542598158,562991333,559979832,276216312,283763520,259867374,49582976,210284398,58565407,151718991,3011501,23035872,10868537,0,15678567
20131216,22188853325,21845722117,787655311,784608599,335409986,449198613,444524103,57594289,386929814,178746767,208183047,3046712,19434210,17095282,972100,20092697
20131217,22411262901,22188853325,693648619,690640424,319355021,371285403,471239043,65344490,405894553,131772131,274122422,3008195,21491467,16776046,2000000,25076977
20131218,22563212893,22411262901,728183881,725021719,340323810,384697909,576233889,49044834,527189055,109517811,417671244,3162162,20650578,10402618,0,17991638
20131219,22629259308,22563212893,615372267,612057170,270457724,341599446,549325852,71116572,478209280,153517329,324691951,3315097,21079321,18473084,10000000,21564167
20131220,22531590203,22629259308,519271840,515937710,197183228,318754482,616940945,53827767,563113178,125909072,437204106,3334130,31032870,8147955,100,14646842
20131221,22679264249,22531590203,502881982,499549288,294402005,205147283,355207936,52259267,302948669,122341797,180606872,3332694,29499842,9000653,0,13758772
20131222,22759637350,22679264249,405171346,401874920,171823041,230051879,324798245,51893078,272905167,92021994,180883173,3296426,23096082,14567354,0,14229642
20131223,22834994651,22759637350,702214591,698715089,315289174,383425915,626857290,88832184,538025106,173502561,364522545,3499502,49661147,18960745,3100000,17110292
20131224,23087198658,22834994651,736775548,733304425,379723180,353581245,484571541,84509016,400062525,166204821,233857704,3471123,49114758,16393210,100,19000948
20131225,23499709057,23087198658,919388088,915576501,455367202,460209299,506877689,81782539,425095150,94451182,330643968,3811587,49100322,13048581,300000,19333636
20131226,23799664680,23499709057,917734452,913737032,444202701,469534331,617778829,73817474,543961355,154785341,389176014,3997420,38868518,15905986,1381200,17661770
20131227,24098116998,23799664680,724902226,720753096,310631469,410121627,426449908,67952629,358497279,136321881,222175398,4149130,41204285,8628549,0,18119795
20131228,24350153515,24098116998,559094795,554910114,187962244,366947870,307058278,59723363,247334915,112007741,135327174,4184681,26883451,15887348,0,16952564
20131229,24677833850,24350153515,657416607,653267159,295644733,357622426,329736272,56831211,272905061,49818600,223086461,4149448,30489061,7225501,510000,18606649
20131230,25082123411,24677833850,1100048262,1095919845,520181602,575738243,695758701,70949283,624809418,204284640,420524778,4128417,39335256,13128284,690000,17795743
20131231,25714553376,25082123411,1030200272,1026080146,424717991,601362155,397770307,68303077,329467230,126261258,203205972,4120126,28054496,18690195,70000,21488386
20140101,26233724392,25714553376,855245984,850839066,288908707,561930359,336074968,65892496,270182472,69079240,201103232,4406918,32752621,12954254,0,20185621
20140102,27053058603,26233724392,1276102700,1271508099,575908746,695599353,456768489,87859580,368908909,103182983,265725926,4594601,41985208,23221702,0,22652670
20140103,27573276722,27053058603,939337476,934726407,375293543,559432864,419119357,97295161,321824196,97179038,224645158,4611069,57940945,16409571,0,22944645
20140104,27977828987,27573276722,684467833,679732956,330049155,349683801,279915568,60196488,219719080,60888638,158830442,4734877,35054089,7988699,0,17153700
20140105,28494789662,27977828987,770822439,766117533,367431496,398686037,253861764,69384045,184477719,45751363,138726356,4704906,37563359,10146851,0,21673835
20140106,29158676228,28494789662,1193473973,1188789646,435630663,753158983,529587407,104603663,424983744,75008489,349975255,4684327,40187230,14967037,22250000,27199396
20140107,29590162430,29158676228,1086836213,1081981842,392657617,689324225,655350011,79481113,575868898,102420105,473448793,4854371,37454010,15520302,0,26506801
20140108,30322925095,29590162430,1254678379,1249479338,333976285,915503053,521915714,109295603,412620111,92367109,320253002,5199041,45035002,20754511,5610000,37896090
20140109,30833444843,30322925095,983934823,978796236,431044124,547752112,473415075,78882716,394532359,78324512,316207847,5138587,23340598,15253891,1200000,39088227
20140110,31315236360,30833444843,964842836,959502078,299455562,660046516,483051319,104554354,378496965,81738496,296758469,5340758,43857994,21823536,1210000,37662824
20140111,31743140238,31315236360,756480003,751176996,276528896,474648100,328576125,84982212,243593913,66093009,177500904,5303007,29722792,27798573,20000,27440847
20140112,32129344822,31743140238,756431519,751157666,293858172,457299494,370226935,85015015,285211920,74653998,210557922,5273853,41546617,9405792,0,34062606
20140113,32979930260,32129344822,1408999028,1403718514,432468438,971250076,558413590,113174247,445239343,112299997,332939346,5280514,54284520,26656409,10000,32223318
20140114,33604422486,32979930260,1248129108,1242755326,385867604,856887722,623636882,92781633,530855249,119051242,411804007,5373782,38530111,23882850,0,30368672
20140115,34377404229,33604422486,1358336590,1352729055,434293960,918435095,585354847,111386281,473968566,145802905,328165661,5607535,45181552,29917949,0,36286780
20140116,34946630288,34377404229,1184253685,1178554318,325304257,853250061,615027626,90514121,524513505,110539666,413973839,5699367,32080882,17346677,300000,40786562
20140117,35298380366,34946630288,1007557758,1001757525,247392122,754365403,655807680,79186928,576620752,132142564,444478188,5800233,33882925,12211540,230000,32862463
20140118,35486739137,35298380366,575276232,569518163,149339087,420179076,386917461,78701555,308215906,106969779,201246127,5758069,33031029,17103640,0,28566886
20140119,35768909978,35486739137,730405427,724686759,183482490,541204269,448234586,73721510,374513076,85684837,288828239,5718668,25874758,19463524,10000,28373228
20140120,36371090284,35768909978,1397929743,1392101895,325398038,1066703857,795749437,132476162,663273275,116312019,546961256,5827848,57444206,37439187,214000,37378769
20140121,36819402120,36371090284,1242415960,1236644371,283556516,953087855,794104124,87814785,706289339,141688941,564600398,5771589,40654866,23839061,50000,23270858
20140122,37464253411,36819402120,1397104858,1391100573,394942057,996158516,752253567,105221771,647031796,125155484,521876312,6004285,47872643,34682816,1000000,21666312
20140123,38047453461,37464253411,1262577349,1256254681,295138283,961116398,679377299,122500584,556876715,115756493,441120222,6322668,62287361,37926899,1600000,20686324
20140124,38833813181,38047453461,1645612024,1639239467,483230946,1156008521,859252304,126114627,733137677,191146458,541991219,6372557,69945181,40147842,0,16021604
20140125,39281004922,38833813181,1178711979,1172434118,325109040,847325078,731520238,124812983,606707255,139778133,466929122,6277861,72053314,31154319,1000,21604350
20140126,40113806835,39281004922,1713541320,1707289956,513971224,1193318732,880739407,106795314,773944093,138982784,634961309,6251364,58816165,33060504,0,14918645
20140127,41523454976,40113806835,2385795314,2379650507,590035197,1789615310,976147173,151562540,824584633,153473992,671110641,6144807,98132438,33412272,420000,19597830
20140128,43792183463,41523454976,3101976669,3095544546,747179476,2348365070,833248182,131962223,701285959,117466912,583819047,6432123,91272499,22806126,200000,17683598
20140129,46368100678,43792183463,3231100931,3224287932,632701326,2591586606,655183716,91882801,563300915,94355711,468945204,6812999,41171772,34298133,0,16412896
20140130,46854899162,46368100678,813019949,806017860,116878053,689139807,326221465,69101407,257120058,50679877,206440181,7002089,46865781,13675798,1000000,7559828
20140131,47004929139,46854899162,297268556,289854330,78200417,211653913,147238579,31164308,116074271,19149475,96924796,7414226,15863859,7920041,0,7380408
20140201,47183194976,47004929139,306403336,298895006,91704160,207190846,128137499,48792905,79344594,23340426,56004168,7508330,31882294,4663338,50000,12197273
20140202,47261911940,47183194976,247332263,239842552,59333056,180509496,168615299,57044219,111571080,18125150,93445930,7489711,37518723,11517822,50000,7957674
20140203,47386789910,47261911940,315009937,307538507,55765645,251772862,190131967,50398471,139733496,28565275,111168221,7471430,38323239,1532428,100000,10442804
20140204,47567681855,47386789910,385640043,378155049,111022146,267132903,204748098,45074393,159673705,20978376,138695329,7484994,23740794,11092174,240000,10001425
20140205,47778078384,47567681855,471949894,464370346,123109733,341260613,261553365,78579366,182973999,31751048,151222951,7579548,50567528,14209777,0,13802061
20140206,48089054672,47778078384,787413900,779815922,150230439,629585483,476437612,81168210,395269402,41496866,353772536,7597978,55585228,6790257,1000000,17792725
20140207,48741989046,48089054672,1613953820,1605902274,388628771,1217273503,961019446,123068095,837951351,105023518,732927833,8051546,60838839,28506248,200000,33523008
20140208,49475695849,48741989046,1322934105,1315002742,287949642,1027053100,589227302,121718115,467509187,99977634,367531553,7931363,62961898,33097137,20000,25639080
20140209,50075543886,49475695849,1304965909,1297097574,340052035,957045539,705117872,114772717,590345155,113610100,476735055,7868335,62299564,25116247,3000000,24356906
20140210,51387086251,50075543886,2467785988,2459901383,683563988,1776337395,1156243623,151916705,1004326918,140305104,864021814,7884605,74022795,50735996,250000,26907914
20140211,52619379241,51387086251,2305648221,2297802480,354470266,1943332214,1073355231,148446010,924909221,108884721,816024500,7845741,61752493,27372740,11000000,48320777
20140212,53874396662,52619379241,2082906843,2074484772,361222754,1713262018,827889422,118293160,709596262,105736949,603859313,8422071,55282100,23279794,60000,39671266
20140213,55000639427,53874396662,2023862072,2015196866,498421379,1516775487,897619307,121667596,775951711,100968403,674983308,8665206,55491682,39556792,1250000,25369122
20140214,55806236503,55000639427,1667222294,1658411224,248442378,1409968846,861625218,276212622,585412596,109640805,475771791,8811070,40335865,28727170,163600000,43549587
20140215,56323769898,55806236503,940909320,931924946,165958223,765966723,423375925,73458906,349917019,89719528,260197491,8984374,34453914,17416601,100,21588291
20140216,57005506808,56323769898,1358243946,1349302863,265087196,1084215667,676507036,102271378,574235658,108295510,465940148,8941083,35703502,39869433,1400000,25298443
20140217,57971933442,57005506808,2050278008,2041416708,499455099,1541961609,1083851374,94749691,989101683,134032981,855068702,8861300,25043551,32155454,2080000,35470686
20140218,59153410932,57971933442,2041088758,2032199737,374943414,1657256323,859611268,96304476,763306792,149990611,613316181,8889021,30237187,28094421,6430100,31542768
20140219,60066040489,59153410932,1988972281,1979633091,381992327,1597640764,1076342724,109296435,967046289,118314237,848732052,9339190,41718431,35236796,501100,31840108
20140220,60682858820,60066040489,1686141954,1676629661,262020057,1414609604,1069323623,163213498,906110125,122579652,783530473,9512293,48340318,35332370,47100000,32440810
20140221,61312803659,60682858820,1407653427,1398026615,252738641,1145287974,777708588,122301183,655407405,95316336,560091069,9626812,61886871,23742052,540000,36132260
20140222,61883371633,61312803659,1012367945,1002618517,194032299,808586218,441799971,110292139,331507832,77687500,253820332,9749428,55764440,9915364,13000000,31612335
20140223,62665668735,61883371633,1337727041,1328034449,323085707,1004948742,555429939,152283723,403146216,72672385,330473831,9692592,76751005,35209692,250000,40073026
20140224,63455921664,62665668735,2081711725,2072016344,508820044,1563196300,1291458796,181483951,1109974845,152362500,957612345,9695381,93962895,43964505,483841,43072710
20140225,63949493852,63455921664,2067472057,2057920198,544995023,1512925175,1573899869,183326020,1390573849,148076220,1242497629,9551859,109522695,35599993,260000,37943332
20140226,64743808998,63949493852,2108362595,2098463586,675678703,1422784883,1314047449,134092240,1179955209,149586900,1030368309,9899009,56827314,35231071,495000,41538855
20140227,65519088430,64743808998,1953502487,1943598910,473991075,1469607835,1178223055,160778309,1017444746,118354206,899090540,9903577,69227837,60165433,217000,31168039
20140228,65979410346,65519088430,1461760369,1451758679,373327073,1078431606,1001438453,176418421,825020032,136793864,688226168,10001690,90222771,38174917,7870000,40150733
20140301,66164186364,65979410346,903808003,893670210,306720236,586949974,719031985,152073493,566958492,114713440,452245052,10137793,78346667,39135156,2000000,32591670
20140302,66399788290,66164186364,902770166,892716198,263347060,629369138,667168240,122042750,545125490,92696098,452429392,10053968,57317688,30311447,250000,34163615
20140303,66699843452,66399788290,1959205390,1949312699,778206761,1171105938,1659150228,165785173,1493365055,169279615,1324085440,9892691,77677108,35614489,210000,52283576
20140304,67297280701,66699843452,1719103693,1709319634,606644359,1102675275,1121666444,157994740,963671704,132020326,831651378,9784059,79777241,41186380,420000,36611119
20140305,67592950199,67297280701,1636329106,1626212288,488015850,1138196438,1340659608,156298595,1184361013,198391689,985969324,10116818,76847282,44591063,882000,33978250
20140306,67863255318,67592950199,1350446630,1340376847,378012037,962364810,1080141511,161884829,918256682,161451591,756805091,10069783,71902435,45861443,2815000,41305951
20140307,68464881733,67863255318,1275418685,1265317871,363661186,901656685,673792270,129720958,544071312,126933967,417137345,10100814,59867015,28099164,51000,41703779
20140308,68527692620,68464881733,725095462,714914429,200867353,514047076,662284575,163327227,498957348,78496842,420460506,10181033,64050493,37563987,5500000,56212747
20140309,68574693327,68527692620,863868715,853752714,223675957,630076757,816868008,122468606,694399402,98358213,596041189,10116001,56397085,19921639,3000000,43149882
20140310,68822713280,68574693327,1566596910,1556637601,446398654,1110238947,1318576957,156290106,1162286851,159219284,1003067567,9959309,62967393,53579688,300000,39443025
20140311,69051568974,68822713280,1420964232,1411069899,398528109,1012541790,1192108538,141477536,1050631002,145927014,904703988,9894333,60416513,41637817,530000,38893206
20140312,69134386199,69051568974,1230934397,1220783640,325341513,895442127,1148117172,160127345,987989827,132553394,855436433,10150757,78620848,37279768,869900,43356829
20140313,69336805525,69134386199,1328546072,1318437460,514503642,803933818,1126126746,149692133,976434613,142261967,834172646,10108612,81021415,31968662,420000,36282056
20140314,69432608546,69336805525,1032832754,1022740021,299462983,723277038,937029733,140258549,796771184,115195839,681575345,10092733,63460095,41752204,1770000,33276250
20140315,69248209470,69432608546,804593572,794448773,216932959,577515814,988992648,97050428,891942220,123743945,768198275,10144799,35413550,33085800,0,28551078
20140316,69286479715,69248209470,916032883,906011152,405486035,500525117,877762638,96476794,781285844,103868534,677417310,10021731,36150414,34399725,202000,25724655
20140317,69427006724,69286479715,1444856542,1435051757,618482745,816569012,1304329533,151052061,1153277472,152552159,1000725313,9804785,49147451,39436370,710200,61758040
20140318,69295849394,69427006724,1081162480,1071333944,303127632,768206312,1212319810,167026058,1045293752,149433898,895859854,9828536,56448538,32089566,651100,77836854
20140319,69348783927,69295849394,1175049310,1164962623,325301370,839661253,1122114777,142324210,979790567,156732942,823057625,10086687,52868428,49893176,40000,39522606
20140320,69482046832,69348783927,1139072271,1128994752,400972850,728021902,1005809366,127632365,878177001,151622910,726554091,10077519,44495386,41174996,150000,41811983
20140321,69645535993,69482046832,901048827,890938419,351644815,539293604,737559666,137055894,600503772,119796860,480706912,10110408,62106835,35593964,0,39355095
20140322,69536140561,69645535993,584423977,574357941,190245798,384112143,693819409,123120523,570698886,87535540,483163346,10066036,50824908,37073328,40000,35182287
20140323,69438006334,69536140561,647030988,637051934,203374963,433676971,745165215,153153706,592011509,76825681,515185828,9979054,76659999,41659040,500900,34333767
20140324,69117403097,69438006334,1141012147,1131186038,479673764,651512274,1461615384,180994238,1280621146,107549008,1173072138,9826109,99401291,37198763,100000,44294184
20140325,68728114888,69117403097,939401225,929693167,286933507,642759660,1328689434,187846604,1140842830,153371852,987470978,9708058,97723159,42021421,140000,47962024
20140326,68640545675,68728114888,1022016290,1012286024,379932470,632353554,1109585503,126546667,983038836,114457451,868581385,9730266,45833016,29295366,725200,50693085
20140327,68304915897,68640545675,887292726,877634611,240577180,637057431,1222922504,146347163,1076575341,111756484,964818857,9658115,63993901,37279871,70000,45003391
20140328,67967511675,68304915897,729091409,719482148,218968944,500513204,1066495631,145146376,921349255,130699071,790650184,9609261,65362705,45327971,2030000,32425700
20140329,67922763060,67967511675,703279492,693691033,338523143,355167890,748028107,108804829,639223278,99488252,539735026,9588459,38808029,28405374,100000,41491426
20140330,67770697113,67922763060,602663436,593149180,207409708,385739472,754729383,90755166,663974217,100321217,563653000,9514256,31146062,29446683,0,30162421
20140331,67546845586,67770697113,1250306245,1240840680,461069042,779771638,1474157772,163985748,1310172024,179565479,1130606545,9465565,60782180,52772986,140000,50290582
20140401,68056207913,67546845586,1602453549,1593046295,729567169,863479126,1093091222,169631640,923459582,147044276,776415306,9407254,79045242,41901448,220000,48464950
20140402,68361695040,68056207913,1232180369,1222623190,477453612,745169578,926693242,171418583,755274659,159692342,595582317,9557179,75240562,39941108,710000,55526913
20140403,68585169140,68361695040,1075779488,1066132658,347023770,719108888,852305388,178305042,674000346,120473293,553527053,9646830,83958453,41364423,1017000,51965166
20140404,68831293474,68585169140,869826250,860142313,229070383,631071930,623701916,136791433,486910483,112619514,374290969,9683937,73475397,29483420,185000,33647616
20140405,69041837626,68831293474,552439004,542708580,195766670,346941910,341894852,94724906,247169946,60521562,186648384,9730424,43909167,19570359,370000,30875380
20140406,69124025698,69041837626,538590199,528897601,216979629,311917972,456402127,97580959,358821168,79195311,279625857,9692598,48541395,19946872,0,29092692
20140407,69128076992,69124025698,786574897,776922226,336495706,440426520,782523603,114764197,667759406,135498791,532260615,9652671,56699923,26095113,0,31969161
20140408,69327094742,69128076992,1190990631,1181358764,449056128,732302636,991972881,184272953,807699928,134942568,672757360,9631867,84261287,42403828,901000,56706838
20140409,69464905907,69327094742,1201961729,1192258784,461331794,730926990,1064150564,183077340,881073224,130974714,750098510,9702945,86306616,44207487,220000,52343237
20140410,69876534061,69464905907,1257791976,1248095096,493002072,755093024,846163822,176044935,670118887,137007430,533111457,9696880,75914793,48467008,11570000,40093134
20140411,70168293875,69876534061,1101567126,1091885188,520898154,570987034,809807312,209970684,599836628,119738065,480098563,9681938,71740151,38467328,54390000,45373205
20140412,70314423276,70168293875,713131643,703391403,286606166,416785237,567002242,146008990,420993252,94544184,326449068,9740240,53625671,30731155,18650000,43002164
20140413,70444820061,70314423276,714597608,704916338,330143843,374772495,584200823,122466374,461734449,68338579,393395870,9681270,49958250,24110605,12000000,36397519
20140414,70470421798,70444820061,1144221932,1134632361,384245334,750387027,1118620195,144600839,974019356,103158371,870860985,9589571,56032119,43782517,300000,44486203
20140415,70608184614,70470421798,1178573487,1169006110,378059146,790946964,1040810671,168968157,871842514,174951578,696890936,9567377,57970021,58916160,2050000,50031976
20140416,70862701955,70608184614,1123610612,1113913719,402066371,711847348,869093271,122613208,746480063,129185338,617294725,9696893,30682949,41416372,1670000,48843887
20140417,71051263038,70862701955,1040319071,1030647646,431613852,599033794,851757988,130365081,721392907,133614682,587778225,9671425,38332918,33201272,3070000,55760891
20140418,71166313036,71051263038,866509633,856821144,325266701,531554443,751459635,136945290,614514345,123757915,490756430,9688489,41922709,37241481,1460000,56321100
20140419,71140531473,71166313036,534994187,525267540,201414030,323853510,560775750,114081868,446693882,105498682,341195200,9726647,46927999,30628109,1165000,35360760
20140420,71029587114,71140531473,552978457,543308309,214211403,329096906,663922816,134697049,529225767,107552070,421673697,9670148,56823645,33002036,800000,44071368
20140421,70987712939,71029587114,1020496868,1010871433,453634358,557237075,1062371043,213143038,849228005,165257296,683970709,9625435,119000749,32833139,5500000,55809150
20140422,71124074416,70987712939,1041906359,1032347118,424550517,607796601,905544882,160388639,745156243,121218301,623937942,9559241,71060430,39724288,350000,49253921
20140423,71073347143,71124074416,1003295467,993722848,386755919,606966929,1054022740,211390894,842631846,126678121,715953725,9572619,113867730,54144710,1550000,41828454
20140424,70990410060,71073347143,862030683,852556789,320378337,532178452,944967766,167556206,777411560,166051372,611360188,9473894,86644613,32386104,6090000,42435489
20140425,71015530364,70990410060,888306160,878881566,318000949,560880617,863185856,190223634,672962222,141165670,531796552,9424594,103303103,34865926,4051000,48003605
20140426,71119546963,71015530364,584376070,574949817,238762521,336187296,480359471,105720290,374639181,81853465,292785716,9426253,50520345,16854793,50000,38295152
20140427,71107452824,71119546963,631881868,622504294,276425959,346078335,643976007,145626801,498349206,108570305,389778901,9377574,84986546,23342715,200000,37097540
20140428,70879697852,71107452824,878628555,869270673,256587473,612683200,1106383527,187448391,918935136,158527464,760407672,9357882,91025145,47230212,1205000,47988034
20140429,70969357936,70879697852,984030109,974733055,373594630,601138425,894370025,160063288,734306737,156428190,577878547,9297054,74046778,37431387,300000,48285123
20140430,71193286436,70969357936,985057730,975599350,373549123,602050227,761129230,169670087,591459143,124152642,467306501,9458380,74096105,53447926,1600000,40526056
20140501,71471610546,71193286436,632162787,622779121,174438549,448340572,353838677,111741062,242097615,65970316,176127299,9383666,59241255,20036438,3900000,28563369
20140502,71601084916,71471610546,517951606,508493486,153861606,354631880,388477236,96637812,291839424,81044488,210794936,9458120,44785113,17804665,100000,33948034
20140503,71612895766,71601084916,615402548,605912018,202571789,403340229,603591698,144678213,458913485,104236197,354677288,9490530,74527622,28039315,3500000,38611276
20140504,71601210043,71612895766,1043538823,1033983467,360785433,673198034,1055224546,240616378,814608168,128585088,686023080,9555356,104119995,78303004,401000,57792379
20140505,71898510426,71601210043,1305407591,1296079615,408058042,888021573,1008107208,233273727,774833481,156425925,618407556,9327976,80592899,45900572,59488812,47291444
20140506,72062332637,71898510426,1295140258,1285541085,451548095,833992990,1131318047,181808717,949509330,141185009,808324321,9599173,79364806,43043925,5460000,53939986
20140507,72311499184,72062332637,1184976594,1175493839,451330467,724163372,935810047,152529284,783280763,150536990,632743773,9482755,70769268,33834347,3950100,43975569
20140508,72353725198,72311499184,972395792,962992561,298908441,664084120,930169778,175187547,754982231,134293103,620689128,9403231,81006973,55788095,323800,38068679
20140509,72586380664,72353725198,895767162,886313411,301189748,585123663,663111696,171606745,491504951,126943933,364561018,9453751,73041850,40248923,16245300,42070672
20140510,72754967864,72586380664,590014111,580611903,185349770,395262133,421426911,142292729,279134182,82045164,197089018,9402208,64452961,41761670,5000,36073098
20140511,72955523368,72754967864,769744332,760375882,283859740,476516142,569188828,155061546,414127282,113655528,300471754,9368450,66842902,38878308,100000,49240336
20140512,72841263580,72955523368,1034878881,1025579947,335712962,689866985,1149138669,199470285,949668384,129301117,820367267,9298934,87928185,53951794,11060000,46530306
20140513,72922793552,72841263580,1110676086,1101460400,438263217,663197183,1029146114,174622921,854523193,137073388,717449805,9215686,72974653,41585542,2000000,58062726
20140514,72768369916,72922793552,877405523,868074279,264090147,603984132,1031829159,199031602,832797557,114103882,718693675,9331244,58013829,46804166,43010000,51203607
20140515,72805156797,72768369916,989700400,980373388,276045073,704328315,952913519,175402476,777511043,127192746,650318297,9327012,36653596,69268564,25700000,43780316
20140516,72874263256,72805156797,830373528,821047585,283182988,537864597,761267069,140153855,621113214,106241569,514871645,9325943,45972318,38759391,1300000,54122146
20140517,72793587910,72874263256,553817765,544581366,220735830,323845536,634493111,116358166,518134945,125155640,392979305,9236399,32131768,37369683,0,46856715
20140518,72832066305,72793587910,670805253,661629571,254866819,406762752,632326858,108651079,523675779,108204650,415471129,9175682,35302087,35336956,2005000,36007036
20140519,72565342788,72832066305,986647698,977195216,358325927,618869289,1253371215,175255998,1078115217,157814744,920300473,9452482,50709933,58022387,9021600,57502078
20140520,72528534045,72565342788,1021891988,1012480218,363518927,648961291,1058700731,158243427,900457304,139972713,760484591,9411770,56293245,49230894,600000,52119288
20140521,72599672366,72528534045,913702550,904237644,307771792,596465852,842564229,183864097,658700132,149117778,509582354,9464906,74796138,60033752,2010000,47024207
20140522,72615864455,72599672366,863613857,854378570,286245245,568133325,847421768,172455673,674966095,151610188,523355907,9235287,75650480,40288079,7100000,49417114
20140523,72732656368,72615864455,789133572,779944112,300437916,479506196,672341659,149409094,522932565,141141690,381790875,9189460,72850314,31270700,20000,45268080
20140524,72660432583,72732656368,521968050,512987845,202016650,310971195,594191835,129096909,465094926,107724907,357370019,8980205,70247120,19693110,240100,38916579
20140525,72514060627,72660432583,537532687,528611091,181701883,346909208,683904643,130887242,553017401,91484927,461532474,8921596,69209798,21077773,2000000,38599671
20140526,72387486975,72514060627,1005409943,996554302,373300154,623254148,1131983595,213614027,918369568,183290402,735079166,8855641,79248745,50233514,26200000,57931768
20140527,72461386701,72387486975,926658750,917797742,326354066,591443676,852759024,157434683,695324341,141223780,554100561,8861008,70232801,30830861,3250000,53121021
20140528,72357397856,72461386701,965489457,956479821,337505474,618974347,1069478302,178071993,891406309,146974389,744431920,9009636,78292515,43266323,3800000,52713155
20140529,72340913310,72357397856,913081309,904242624,368577651,535664973,929565855,190099580,739466275,166015847,573450428,8838685,80861086,61209932,5500000,42528562
20140530,72324639838,72340913310,805401221,796266964,276629337,519637627,821674693,166730948,654943745,138207352,516736393,9134257,57330492,59793373,6100000,43507083
20140531,72320474651,72324639838,482170012,473319498,177744018,295575480,486335199,108429414,377905785,98583365,279322420,8850514,39291189,30476013,10000,38652212
20140601,72431256720,72320474651,620961130,612159793,218567812,393591981,510179061,133810740,376368321,84524611,291843710,8801337,63998817,34287082,0,35524841
20140602,72498830015,72431256720,593886671,585165383,161469234,423696149,526313376,114305924,412007452,89026200,322981252,8721288,62318453,16432319,100000,35455152
20140603,72310721067,72498830015,1074740886,1065879756,351243597,714636159,1262849834,201156429,1061693405,153040393,908653012,8861130,98792158,44638966,3500000,54225305
20140604,72429170764,72310721067,1130255625,1121269877,426678527,694591350,1011805928,212035271,799770657,168533367,631237290,8985748,104115887,51509769,2050900,54358715
20140605,72576494583,72429170764,1104013595,1094871528,385496448,709375080,956689776,269863795,686825981,165098968,521727013,9142067,77613655,48821595,98600000,44828545
20140606,72556851790,72576494583,821082370,812160826,286146650,526014176,840725163,183637085,657088078,129138867,527949211,8921544,78740105,46358259,1000000,57538721
20140607,72637670162,72556851790,601054953,592106330,229650378,362455952,520236581,133791185,386445396,97990788,288454608,8948623,57624198,38834048,2120000,35212939
20140608,72689809840,72637670162,591554594,582650944,217634462,365016482,539414916,137554069,401860847,97553451,304307396,8903650,69138033,34238055,0,34177981
20140609,72753163312,72689809840,1054908200,1045876783,378089864,667786919,991554728,188986651,802568077,133855934,668712143,9031417,73050738,68914234,0,47021679
20140610,72891156948,72753163312,1096021712,1087072570,295455145,791617425,958028076,188532392,769495684,140549540,628946144,8949142,79422176,57628516,1800000,49681700
20140611,73153753568,72891156948,1111817011,1102681449,395741689,706939760,849220391,159342512,689877879,156098967,533778912,9135562,66957512,42539218,370000,49475782
20140612,73155850313,73153753568,880170435,871072429,282428003,588644426,878073690,241308724,636764966,137726682,499038284,9098006,64223421,73415871,63030000,40639432
20140613,73294752375,73155850313,850207051,840956115,265135433,575820682,711304989,167478454,543826535,128345144,415481391,9250936,76443046,37017466,2900000,51117942
20140614,73298106083,73294752375,587937861,578751161,204680029,374071132,584584153,105094085,479490068,120486034,359004034,9186700,42608343,30682541,25000,31778201
20140615,73236886414,73298106083,585960916,576829585,186858516,389971069,647180585,118103654,529076931,100852118,428224813,9131331,52694980,28510108,50000,36848566
20140616,73214720263,73236886414,1092897875,1083894565,370704120,713190445,1115064026,180803102,934260924,144224315,790036609,9003310,59490316,65998274,1000000,54314512
20140617,73100934696,73214720263,1016229512,1007368671,356114409,651254262,1130015079,197592654,932422425,130467344,801955081,8860841,53130084,42573920,42517138,59371512
20140618,72721757823,73100934696,870198276,861368776,274191677,587177099,1249375149,151592209,1097782940,138991421,958791519,8829500,36112646,44361878,110000,71007685
20140619,72431954387,72721757823,835807322,827235099,229332282,597902817,1125610758,170573846,955036912,141532481,813504431,8572223,54472169,44819215,1700000,69582462
20140620,72188904747,72431954387,772061554,763230717,308722826,454507891,1015111194,174552827,840558367,165388019,675170348,8830837,75734876,45350144,1900000,51567807
20140621,72100655330,72188904747,533479839,525070777,191427823,333642954,621729256,127443578,494285678,109362064,384923614,8409062,54282703,32356997,10000,40793878
20140622,71958107107,72100655330,551920039,543569971,190999166,352570805,694468262,126831734,567636528,115411799,452224729,8350068,54183082,38683866,0,33964786
20140623,71389335268,71958107107,900025202,891702546,275448888,616253658,1468797041,182635064,1286161977,159982693,1126179284,8322656,84481315,53733157,100000,44320592
20140624,70786196664,71389335268,883939317,875662346,303399945,572262401,1487077921,256843250,1230234671,194559751,1035674920,8276971,93702285,30067016,72800000,60273949
20140625,70585867963,70786196664,1073343947,1065391121,444203554,621187567,1273672648,227003306,1046669342,160130080,886539262,7952826,117606706,37915173,19300000,52181427
20140626,70181825905,70585867963,930487774,922718867,317251841,605467026,1334529832,214513141,1120016691,179180552,940836139,7768907,82581612,39806651,27500000,64624878
20140627,69858716525,70181825905,756016734,748119866,266017733,482102133,1079126114,158762739,920363375,179442358,740921017,7896868,56888136,32307667,19350000,50216936
20140628,69627686115,69858716525,515523132,507755255,161252213,346503042,746553542,142151747,604401795,149398400,455003395,7767877,60074697,39307033,0,42770017
20140629,69228426225,69627686115,532360147,524657582,169368616,355288966,931620037,143008348,788611689,159043638,629568051,7702565,57523858,39313523,1000200,45170767
20140630,68796307535,69228426225,1081686146,1074073648,290840271,783233377,1513804836,208784933,1305019903,204279809,1100740094,7612498,69826228,64220358,11000200,63738147
20140701,68940550399,68796307535,1296682479,1288890318,336690914,952199404,1152439615,202155507,950284108,183939645,766344463,7792161,83342920,55118589,7000200,56693798
20140702,68907063702,68940550399,1204988761,1197288163,461537009,735751154,1238475458,219053263,1019422195,142276867,877145328,7700598,81254531,77254569,6000000,54544163
20140703,68717285510,68907063702,875335207,867650694,321879841,545770853,1065113399,207855707,857257692,131483120,725774572,7684513,74917582,70785778,20730000,41422347
20140704,68859236210,68717285510,863197730,855585658,343029166,512556492,721247030,176245639,545001391,153432354,391569037,7612072,68020805,46440271,2125200,59659363
20140705,68882162274,68859236210,655224365,647604544,282703465,364901079,632298301,142205617,490092684,114144984,375947700,7619821,61079535,35080972,200000,45845110
20140706,68898665003,68882162274,567300933,559729862,167698999,392030863,550798204,125616882,425181322,79851352,345329970,7571071,52938623,35332476,300000,37045783
20140707,68874157399,68898665003,1040158032,1032622538,434546170,598076368,1064665636,214715696,849949940,150213163,699736777,7535494,106061724,58333075,400000,49920897
20140708,68754767595,68874157399,894109101,886620773,308992929,577627844,1013498905,205656047,807842858,157124939,650717919,7488328,76191507,41922324,37300000,50242216
20140709,68365789973,68754767595,839909447,832332401,280703194,551629207,1228887069,191127889,1037759180,145572057,892187123,7577046,80189619,54101316,1510000,55326954
20140710,68311809213,68365789973,1010415719,1002780672,260147523,742633149,1064396479,203689417,860707062,152460845,708246217,7635047,97873415,47633293,6580300,51602409
20140711,68297581007,68311809213,719653826,712110920,225764017,486346903,733882032,178475255,555406777,110048866,445357911,7542906,79227798,50394483,3200200,45652774
20140712,68197834780,68297581007,533527578,526009760,197743145,328266615,633273805,155381166,477892639,97009279,380883360,7517818,57691473,45479739,5080000,47129954
20140713,68186466198,68197834780,545617754,538156170,200166670,337989500,556986336,145302512,411683824,95250121,316433703,7461584,64817423,35067349,1000000,44417740
20140714,68009688676,68186466198,953017630,945487712,388741695,556746017,1129795152,184768281,945026871,158695093,786331778,7529918,83875029,52839818,3500000,44553434
20140715,68095753580,68009688676,1012388973,1004868328,282131745,722736583,926324069,163069859,763254210,133516979,629737231,7520645,57516774,37309239,23832000,44411846
20140716,68208215658,68095753580,1046172434,1038541928,314186682,724355246,933710356,176098040,757612316,141236544,616375772,7630506,54534882,56203781,23072000,42287377
20140717,68018534260,68208215658,829079552,821601986,273312530,548289456,1018760950,221856127,796904823,116184191,680720632,7477566,37115686,48858907,87100000,48781534
20140718,67885778996,68018534260,698197549,690662445,212489673,478172772,830952813,143470564,687482249,162434914,525047335,7535104,53585113,47847037,120000,41918414
20140719,67837244269,67885778996,584078973,576602177,221550494,355051683,632613700,121523777,511089923,107417150,403672773,7476796,35405989,42405826,300000,43411962
20140720,67665283186,67837244269,547878115,540454575,190841504,349613071,719839198,156118595,563720603,87714527,476006076,7423540,69773424,48718594,0,37626577
20140721,67227431222,67665283186,752517994,744955027,240347522,504607505,1190369958,198666940,991703018,156847499,834855519,7562967,78967846,63094976,100000,56504118
20140722,66832929351,67227431222,917908600,910575910,342797373,567778537,1312410471,284685806,1027724665,165666604,862058061,7332690,82208454,62278838,87822000,52376514
20140723,66623829737,66832929351,907384527,899957333,338313184,561644149,1116484141,191225030,925259111,187737733,737521378,7427194,66100759,45689578,16210000,63224693
20140724,66388864089,66623829737,890196859,882820571,362207813,520612758,1125162507,281559285,843603222,135393196,708210026,7376288,101620926,60680699,65010000,54247660
20140725,66442520388,66388864089,765342921,757980513,240721189,517259324,711686622,235679115,476007507,97050013,378957494,7362408,93335474,66555747,33000000,42787894
20140726,66339575185,66442520388,475335274,467964804,156741896,311222908,578280477,144842340,433438137,103142369,330295768,7370470,61072021,38215973,3201000,42353346
20140727,66211849247,66339575185,479883545,472562906,186035894,286527012,607609483,148912822,458696661,120432886,338263775,7320639,68954952,32485044,5900000,41572826
20140728,65963107591,66211849247,954515564,947206305,378356826,568849479,1203257220,254761980,948495240,149175354,799319886,7309259,84034210,62288551,57400000,51039219
20140729,65973029055,65963107591,863222138,856037951,316508573,539529378,853300674,153629013,699671661,126534228,573137433,7184187,46118419,57976257,901000,48633337
20140730,65830318444,65973029055,792987952,785722323,259862672,525859651,935698563,188569153,747129410,148855144,598274266,7265629,63337481,50701474,21426343,53103855
20140731,65536288799,65830318444,841205304,833950944,291667724,542283220,1135234949,230191714,905043235,153801849,751241386,7254360,64914191,50490024,60980000,53807499
20140801,65565440408,65536288799,899207505,891979615,213425517,678554098,870055896,207714036,662341860,171526338,490815522,7227890,79746579,65867369,17800000,44300088
20140802,65628252394,65565440408,553713472,546484847,184455901,362028946,490901486,162483661,328417825,68753058,259664767,7228625,61507618,48574631,2000000,50401412
20140803,65553846549,65628252394,588337156,581147791,188833138,392314653,662743001,159530256,503212745,69551437,433661308,7189365,71406762,45724659,10000,42388835
20140804,65719751603,65553846549,1049941667,1042629735,373308960,669320775,884036613,216764024,667272589,124675446,542597143,7311932,77289733,76052202,4350000,59072089
20140805,65805313762,65719751603,982923372,975766997,343696873,632070124,897361213,235709365,661651848,109690601,551961247,7156375,80102576,52980904,52570000,50055885
20140806,65679862576,65805313762,821624166,814386834,226273114,588113720,947075352,196264253,750811099,121876933,628934166,7237332,90022567,55851381,2550000,47840305
20140807,65514291787,65679862576,717159084,709906479,220582882,489323597,882729873,206506193,676223680,116451848,559771832,7252605,79036351,47848970,32326000,47294872
20140808,65578490545,65514291787,915416806,908034468,354726074,553308394,851218048,209410469,641807579,115042769,526764810,7382338,70973627,56058076,33260000,49118766
20140809,65593212489,65578490545,499046981,491822561,175976627,315845934,484325037,143080730,341244307,93980440,247263867,7224420,46162069,49072642,2192000,45654019
20140810,65542883691,65593212489,530489028,523300699,194621574,328679125,580817826,149862543,430955283,76366749,354588534,7188329,70216044,40045442,760000,38841057
20140811,65477304010,65542883691,919174454,911988239,262481269,649506970,984754135,204805372,779948763,146591956,633356807,7186215,74372739,50898814,24931000,54602819
20140812,65435071632,65477304010,878516336,871397984,264662354,606735630,920748714,201433824,719314890,108651704,610663186,7118352,74313455,45200799,11111200,70808370
20140813,65344859042,65435071632,884906550,877715152,308207985,569507167,975119140,175929020,799190120,128961279,670228841,7191398,63393736,59092823,1600000,51842461
20140814,65378705505,65344859042,739609433,732284917,220390240,511894677,705762970,137322076,568440894,110484844,457956050,7324516,49626416,42741132,4888000,40066528
20140815,65341164560,65378705505,846900620,839710126,293054796,546655330,884441565,162831602,721609963,109768094,611841869,7190494,52200922,60381079,3880000,46369601
20140816,65384094908,65341164560,609321425,602141147,221190854,380950293,566391077,147333278,419057799,104184040,314873759,7180278,48163716,49877329,800000,48492233
20140817,65352445911,65384094908,553824888,546688383,175378235,371310148,585473885,127061374,458412511,133861520,324550991,7136505,39995333,44275935,906000,41884106
20140818,65492816671,65352445911,1062823237,1055730765,404586397,651144368,922452477,205324683,717127794,166336982,550790812,7092472,58890277,56959821,3101000,86373585
20140819,65635668958,65492816671,997884612,990741123,398290112,592451011,855032325,282425858,572606467,76993528,495612939,7143489,61130966,51050187,51573000,118671705
20140820,65627637397,65635668958,935285782,928022033,330762527,597259506,943317343,288346450,654970893,96885437,558085456,7263749,84569187,54822407,981000,147973856
20140821,65632876866,65627637397,844953019,837727344,244712427,593014917,839713550,279858371,559855179,95314863,464540316,7225675,75322672,76770448,5540000,122225251
20140822,65504656121,65632876866,707399092,700246898,265587597,434659301,835619837,273355869,562263968,103599383,458664585,7152194,87403590,61963832,1500000,122488447
20140823,65361988723,65504656121,514308052,507183798,200894378,306289420,656975450,267079753,389895697,83730139,306165558,7124254,92643057,49247436,103200,125086060
20140824,65191845358,65361988723,531523508,524450769,223299179,301151590,701666873,257685496,443981377,78978094,365003283,7072739,107309146,41434063,5211000,103731287
20140825,64961166294,65191845358,863358405,856255476,234520553,621734923,1094037469,313224501,780812968,124032737,656780231,7102929,102928381,43972422,8990000,157333698
20140826,64622229459,64961166294,772860520,765821630,261376484,504445146,1111797355,276814809,834982546,91358829,743623717,7038890,73216320,53955375,5591000,144052114
20140827,64183889328,64622229459,861930531,854856586,295431153,559425433,1300270662,348308161,951962501,123127330,828835171,7073945,88342585,75382337,65750000,118833239
20140828,63908974158,64183889328,874390315,867399619,268155983,599243636,1149305485,315954450,833351035,115074028,718277007,6990696,89843505,64201027,12750000,149159918
20140829,63744396843,63908974158,826453756,819408584,255466558,563942026,991031071,291202109,699828962,120768291,579060671,7045172,64452230,67735826,3700000,155314053
20140830,63679598594,63744396843,637204461,630149940,252249630,377900310,702002710,284813970,417188740,84289315,332899425,7054521,51812162,31033326,74835509,127132973
20140831,63617837500,63679598594,696965022,689965004,287123882,402841122,758726116,252618869,506107247,94574934,411532313,7000018,62724414,57501492,6217678,126175285
